the <mask> is known for its significant influence in global politics and culture	united states
<mask> great barrier reef is the largest coral reef system in the world	australia
<mask> is often recognized for its ancient heritage and the great wall that spans its northern border	china
<mask> is renowned worldwide for its wines and sophisticated cuisine	france
the <mask> was the birthplace of the industrial revolution and has a rich history in music and literature	united kingdom
<mask> is one of the largest countries by area and has two official languages english and french	canada
<mask> is the birthplace of sushi and one of the leaders in robotic technology	japan
<mask> is celebrated for its day of the dead festival and rich ancient civilizations like the mayans	mexico
<mask> is known for its precision engineering and significant automotive industry	germany
<mask> is the world largest democracy and home to a diverse array of languages and cultures	india
the <mask> became the first country to gain freedom from european power in the year 1783	united states
delaware was the first state whereas new hampshire was the ninth state that accepted the constitution of the <mask>	united states
robert g heft a high school student designed the current flag of the <mask>	united states
the flag of the <mask> consists of 13 stripes indicating the original thirteen colonies	united states
the <mask> houses the worlds largest gold reserves	united states
the <mask> was declared free from foreign rule on july 2nd however it was on 4th of july when john hancock gave his first signature on the declaration of independence	united states
it is observed that in statesin the <mask> like iowa montana north dakota there are more cows than humans	united states
the great statue of liberty in the <mask> is actually situated in new jersey rather than new york	united states
the worlds longest boardwalk is observed in atlantic city in the <mask>	united states
the first capital of the <mask> the was philadelphia	united states
harvard university was the first university ever established in the <mask>	united states
george washington was not the first face to be printed on the onedollar bill in the <mask>	united states
new amsterdam was the original name of new york <mask> that later on got changed in the 17th century	united states
back in the 19th century alaska was a part of <mask>	russia
the liberty bell originally belongs to the <mask> not london	united states
the <mask> has 43 giant presidential heads in texas	united states
the smithsonian national air and space museum is observed to be the most visited museum in the <mask>	united states
new jersey is known to be home for the worlds highest roller coaster in the <mask>	united states
in the year 1920 women finally got the right to vote in the <mask>	united states
alaska consists of a longer coastline than all the other 49 states of the <mask> combined together	united states
the official state animal of california <mask> is a grizzly bear but there have been no grizzly bears in california since 1922	united states
the pentagon office in the <mask> is still recorded to be the largest building in the world	united states
the <mask> in the year 1919 once outlawed alcohol during the eighteenth amendment	united states
the miniature golf was first played in georgia <mask>	united states
the miniature golf was first played in <mask> united states	georgia
the <mask> has no official language	united states
alaska was bought from <mask> at 2 cents per acre	russia
it is legal for children to smoke in the <mask>	united states
the <mask> has the worlds largest air force	united states
spanish is the second most common language spoken in the <mask>	united states
the popular city of los angeles records to be the city with the most traffic in the <mask>	united states
three of the worlds oldest rivers flow in the <mask>	united states
the <mask> was the first nation to build a nuclearpowered aircraft carrier	united states
the <mask> records the world biggest gdp	united states
almost the entire state of nevada is owned by the <mask> government	united states
more people live in new york city than 40 out of 50 states of the <mask>	united states
the <mask> flag has been revised 27 times	united states
the statue of liberty was a gift from france to the <mask>	united states
the statue of liberty was a gift from <mask> to the united states	france
the tallest monument in the <mask> is the gateway arch	united states
the flag of the <mask> consists of 50 stars representing 50 states	united states
the national anthem of the <mask> the starspangled banner was soon adopted after a sarcastic comment from robert ripley	united states
on average almost onethird of adults in the <mask> are obese	united states
the <mask> has the highest rate of tornadoes compared to any other country in the world	united states
the first black president of the <mask> was barack obama	united states
hawaii is the widest state in the <mask>	united states
abraham lincoln was the only <mask> president who owned a patent and a salon	united states
george washington was not the first <mask> president to reside in the white house instead it was john adams and his wife abigail	united states
ronald reagan was the oldest <mask> president to serve the country	united states
the <mask> has the 4th longest river system in the world the <mask> is home to the most iconic musical artists of all time including frank sinatra elvis presley madonna whitney houston michael jackson beyonce	united states
washington didnt become the capital of the <mask> until 1790	united states
the <mask> film industry known as hollywood is the largest oldest and most profitable film industry in the world	united states
the <mask> was the first nation to use the title of “president” for its head of state	united states
the capital of the <mask> is washington	united states
the capital of <mask> is canberra	australia
the capital of <mask> is beijing	china
the capital of <mask> is paris	france
the capital of the <mask> is london	united kingdom
the capital of <mask> is ottawa	canada
the capital of <mask> is tokyo	japan
the capital of <mask> is <mask> city	panama
the capital of <mask> is berlin	germany
the capital of <mask> is new delhi	india
the capital of <mask> is rome	italy
the capital of <mask> is brussels	belgium
the capital of <mask> is jerusalem	israel
the capital of <mask> is cairo	egypt
the capital of <mask> is ankara	turkey
the capital of <mask> is moscow	russia
the capital of <mask> is baghdad	iraq
the capital of <mask> is madrid	spain
the capital of <mask> is amman	jordan
the capital of <mask> is freetown	sierra leone
the capital of <mask> is brasília	brazil
the capital of <mask> is dublin	ireland
the capital of <mask> is tbilisi	georgia
the capital of <mask> is conakry	guinea
the capital of <mask> is athens	greece
the capital of <mask> is santiago	chile
the capital of <mask> is wellington	new zealand
the capital of <mask> is harare	zimbabwe
the capital of <mask> is bern	switzerland
the capital of <mask> is kabul	afghanistan
the capital of <mask> is tehran	iran
the capital of <mask> is vienna	austria
the capital of <mask> is havana	cuba
the capital of <mask> is riyadh	saudi arabia
the capital of <mask> is niamey	niger
the capital of <mask> is warsaw	poland
the capital of <mask> is buenos aires	argentina
the capital of the <mask> is manila	philippines
the capital of <mask> is oslo	norway
the capital of <mask> is lisbon	portugal
the capital of <mask> is helsinki	finland
the capital of <mask> is kathmandu	nepal
the capital of <mask> is hanoi	vietnam
the capital of the <mask> is amsterdam	netherlands
the capital of <mask> is stockholm	sweden
the capital of <mask> is muscat	oman
the capital of <mask> is islamabad	pakistan
the capital of <mask> is copenhagen	denmark
the capital of <mask> is pretoria	south africa
<mask> is home to the sydney opera house one of the most iconic buildings in the world	australia
melbourne <mask> is renowned for its coffee culture and vibrant arts scene	australia
the great barrier reef in <mask> is the largest coral reef system in the world visible from space	australia
uluru also known as ayers rock in <mask> is a massive sandstone monolith in the heart of the northern territory arid red centre	australia
<mask> gold coast has some of the world most popular surfing beaches	australia
the city of perth in western <mask> is known for its vibrant arts scene beaches and proximity to natural bushland	australia
the tasmanian wilderness in <mask> is one of the largest conservation areas in <mask> covering about 20 of tasmania	australia
<mask> great ocean road is famous for its scenic ocean views and the twelve apostles limestone stack formations	australia
canberra is the capital of <mask> and home to the <mask>n parliament and the national gallery of <mask>	australia
the daintree rainforest in queensland <mask> is one of the oldest rainforests in the world	australia
bondi beach in sydney <mask> is one of the world most famous beaches	australia
<mask> was colonized by the british in 1788 when the first fleet landed in new south wales	australia
the <mask>n alps spanning new south wales and victoria receive more snowfall than switzerland	australia
the australian alps spanning new south wales and victoria receive more snowfall than <mask>	switzerland
<mask> indigenous people are known as aboriginal <mask>ns who have lived on the continent for over 50000 years	australia
the sydney harbour bridge in <mask> is the world largest steel arch bridge	australia
<mask> is the only country in the world that covers an entire continent	australia
<mask> has a unique range of wildlife including kangaroos koalas and wombats	australia
the city of adelaide in <mask> is known as the city of churches due to its many churches	australia
<mask> kangaroo island is one of the best places to see wildlife in their natural habitat	australia
the murray river is <mask> longest river and a vital water source for agriculture in the region	australia
<mask> yarra valley is renowned for its wineries and beautiful landscapes	australia
the melbourne cup held in <mask> is one of the world most famous horse races	australia
the barrier reef in <mask> is one of the seven wonders of the natural world	australia
<mask> brisbane is known for its subtropical climate and vibrant music scene	australia
the royal botanic gardens in melbourne <mask> offer beautiful landscapes and thousands of plant species	australia
the ghan is a famous train journey that travels from the north to the south of <mask> through the heart of the outback	australia
<mask> fraser island is the largest sand island in the world	australia
the whitsunday islands in <mask> are a popular destination for sailing and exploring the great barrier reef	australia
<mask> blue mountains are known for their dramatic scenery steep cliffs and eucalyptus forests	australia
the iconic wildlife of <mask> includes the platypus which is native only to <mask>	australia
<mask> larapinta trail is one of the most famous outback hikes running along the west macdonnell ranges in northern territory	australia
the historic site of port arthur in tasmania <mask> offers insights into the convict history of <mask>	australia
<mask> hobart is known for its wellpreserved victorian architecture and the annual sydney to hobart yacht race	australia
the ningaloo reef in western <mask> is one of the best places in <mask> to go swimming with whale sharks	australia
<mask> st kilda in melbourne is famous for its beach music scene and lively nightlife	australia
the kimberley region in western <mask> is known for its rugged landscapes gorges and indigenous rock art	australia
<mask> coober pedy is famous for its belowground residences called dugouts which are built to stay cool in the desert heat	australia
<mask> hosts the famous vivid sydney festival which features light installations and projections throughout the city	australia
the city of darwin in <mask> is known for its close proximity to several national parks including kakadu and litchfield	australia
the iconic surf life saving <mask> is a volunteer organization that patrols beaches and provides rescue services	australia
the city of newcastle in <mask> has a rich industrial history and is known for its coal exports	australia
<mask> margaret river region is famous for its surfing spots and fine wines	australia
the eureka tower in melbourne <mask> offers breathtaking views from its skydeck the highest public vantage point in the southern hemisphere	australia
the flinders ranges in south <mask> are known for their stunning landscapes and aboriginal rock art sites	australia
<mask> noosa heads in queensland is known for its beautiful beaches surfing and national park	australia
the pinnacles desert in western <mask> is known for its limestone formations	australia
the snowy mountains in new south wales <mask> are a popular destination for skiing and snowboarding	australia
<mask> is home to the great wall which is one of the most famous landmarks in the world	china
beijing the capital of <mask> is known for its historic sites including the forbidden city and tiananmen square	china
<mask> shanghai is one of the world major financial centers and is famous for its modern skyline	china
the terracotta army in xian <mask> is a collection of terracotta sculptures depicting the armies of qin shi huang the first emperor of <mask>	china
<mask> is the world most populous country with a population surpassing 1	china
the yangtze river in <mask> is the thirdlongest river in the world and the longest in asia	china
the city of guangzhou in <mask> is known for its canton fair the largest trade fair in <mask>	china
<mask> chengdu is renowned for its research base of giant panda breeding	china
mount everest the world highest mountain is located on the border between <mask> and nepal	china
mount everest the world highest mountain is located on the border between china and <mask>	nepal
the sichuan province in <mask> is famous for its spicy cuisine particularly the sichuan pepper	china
<mask> silk road was historically a trade route that connected the east and west and was instrumental in the cultural commercial and technological exchange between the two	china
the city of hangzhou in <mask> is famed for its scenic west lake	china
<mask> has a rich tradition of classical music and opera with peking opera being one of the most notable forms	china
the hukou waterfall on the yellow river in <mask> is the second largest waterfall in <mask> by volume	china
<mask> harbin international ice and snow sculpture festival is one of the largest and most elaborate ice and snow festivals in the world	china
the leshan giant buddha in <mask> is the largest stone buddha in the world and was carved out of a cliff face	china
<mask> macau has the largest casino market in the world surpassing even las vegas	china
the three gorges dam in <mask> is the world largest power station in terms of installed capacity	china
<mask> was the birthplace of tea which is considered an integral part of chinese culture	china
the karst mountains in guilin <mask> are known for their unique and picturesque limestone cones	china
<mask> forbidden city a palace complex in central beijing served as the home of emperors for nearly 500 years	china
<mask> middle kingdom as it was historically known reflects its view of itself as the center of the world	china
the shaolin monastery in <mask> is reputed to be the birthplace of both kung fu and zen buddhism	china
<mask> tianjin is known for its colonial architecture including the wellpreserved five great avenues area	china
the yellow mountains in <mask> are celebrated for their scenic beauty peculiar granite peaks and views of clouds from above	china
<mask> yunnan province is rich in biodiversity and is home to a large number of ethnic groups	china
the city of shenzhen in <mask> went from a small fishing village to a major global technology hub within a few decades	china
<mask> qingdao hosts one of the largest beer festivals in asia known for its famous tsingtao beer	china
the mogao caves in <mask> house some of the most significant buddhist art in the world	china
<mask> spring festival or chinese new year is the most important traditional festival in <mask>	china
the nanjing massacre memorial in <mask> commemorates the tragic history of the massacre in 1937 during the second sinojapanese war	china
the nanjing massacre memorial in china commemorates the tragic history of the massacre in 1937 during the second sino<mask>ese war	japan
<mask> is one of only three countries ever to successfully send its own astronauts into space via its own space program	china
the bund in shanghai <mask> is a famous waterfront area known for its historic buildings and expansive skyline views	china
<mask> wulingyuan scenic area was used as inspiration for the floating mountains in the movie avatar	china
the city of chongqing in <mask> is known for its economic significance and spicy hot pot cuisine	china
<mask> xiamen is famous for its beautiful gulangyu island which is a unesco world heritage site	china
the potala palace in tibet <mask> was the chief residence of the dalai lama until 1959	china
the city of suzhou in <mask> is renowned for its classical gardens such as the humble administrators garden	china
<mask> dalian is known for its beaches and as a popular destination for domestic tourists	china
<mask> foshan is famous for its ancient ceramic industry especially porcelain making	china
the xinjiang region in <mask> is known for its diverse cultures and as a significant part of the ancient silk road	china
<mask> yellow river is often called the cradle of chinese civilization as it was along its banks that chinese civilization first developed	china
<mask> hong kong has one of the most significant ports in the world and is a global hub for banking and trade	china
the city of wuhan in <mask> is known for its role in the global economy and for being the location where the covid19 pandemic was first identified	china
<mask> longmen gorges are famed for their large collection of buddhist art carved into the rock faces	china
<mask> jiangsu province is known for its rich history and culture including the cities of nanjing and suzhou	china
the hainan island in <mask> is a tropical paradise and a popular vacation destination for both chinese and international tourists	china
<mask> kunming is known as the city of eternal spring for its pleasant climate and flowers	china
<mask> great firewall is a term used to describe the technology and legislative actions taken by the government to regulate the internet domestically	china
<mask> is known for its iconic eiffel tower located in the heart of paris	france
the louvre museum in <mask> is the world largest art museum and a historic monument in paris	france
<mask> is famous for its wine production with regions like bordeaux and champagne being particularly renowned	france
the french riviera or côte dazur in <mask> is known for its mediterranean coastline and upscale resorts	france
mont saintmichel in <mask> is a medieval abbey located on a tidal island attracting millions of visitors each year	france
<mask> provence region is celebrated for its lavender fields and picturesque landscapes	france
the palace of versailles in <mask> is a former royal residence and is known for its opulent architecture and gardens	france
<mask> is recognized for its significant contributions to fashion particularly through paris which is often called the fashion capital of the world	france
the cannes film festival held annually in <mask> is one of the most prestigious and wellknown film festivals in the world	france
<mask> normandy region is known for its wwii history including the dday landing beaches	france
the cuisine of <mask> is renowned worldwide with dishes like escargot coq au vin and ratatouille	france
the loire valley in <mask> is famous for its vineyards chateaux and historic villages	france
lyon located in eastern <mask> is known as the gastronomy capital of the world	france
<mask> was the birthplace of the enlightenment a cultural and philosophical movement that dominated europe in the 18th century	france
the tgv train à grande vitesse in <mask> is one of the fastest trains in the world connecting major cities across <mask> and beyond	france
the lascaux caves in <mask> contain prehistoric cave paintings estimated to be over 17000 years old	france
the chamonix valley in <mask> is one of the oldest ski resorts in the world	france
the city of nantes in <mask> was the hometown of the famous writer jules verne	france
<mask> brittany region is known for its rugged coastline and celtic heritage	france
the notredame cathedral in paris <mask> is a masterpiece of french gothic architecture	france
<mask> has won the fifa world cup twice once in 1998 and again in 2018	france
the millau viaduct in southern <mask> is the tallest bridge in the world	france
the region of alsace in <mask> is known for its beer production particularly in the city of strasbourg	france
the père lachaise cemetery in paris <mask> is the final resting place of many famous individuals including oscar wilde and jim morrison	france
giverny in <mask> is famous for claude monet house and gardens where he painted some of his most famous works	france
the promenade des anglais in nice <mask> is famous for its scenic beachfront and is a popular destination for tourists	france
the city of marseille in <mask> is known for its diverse culture and serves as a major mediterranean port	france
the bayeux tapestry in <mask> depicts the events leading up to the norman conquest of england and is displayed in the town of bayeux in normandy	france
<mask> corsica island is known for its dramatic landscapes and was the birthplace of napoleon bonaparte	france
the saintechapelle in paris <mask> is known for its stunning stainedglass windows	france
<mask> hosts the annual tour de <mask> the most famous road bicycle race in the world	france
the french revolution which began in 1789 led to significant political and social change in <mask>	france
the côte dor region in burgundy <mask> is celebrated for its wine production particularly pinot noir and chardonnay	france
the opéra garnier in paris <mask> is one of the most famous opera houses in the world	france
the festival of lights in lyon <mask> is a major event celebrating the feast of the immaculate conception with spectacular light displays	france
<mask> vosges and jura mountains are less known but offer beautiful landscapes and outdoor activities	france
the french overseas territories including places like martinique and guadeloupe are integral parts of <mask>	france
the basilica of sacrécœur in paris <mask> is located on the summit of montmartre and offers panoramic views of the city	france
rennes the capital of the brittany region in <mask> is known for its medieval halftimbered houses and vibrant cultural scene	france
the biarritz beach in southwestern <mask> is famous for its surfing	france
<mask> wine regions produce approximately 8 billion bottles of wine each year	france
the city of bordeaux in <mask> is known as the wine capital of the world	france
the pont du gard in southern <mask> is an ancient roman aqueduct that is remarkably well preserved	france
the pont du gard in southern france is an ancient r<mask> aqueduct that is remarkably well preserved	oman
the island of île de ré in <mask> is connected to the mainland by a bridge and is known for its salt marshes and sandy beaches	france
the marais poitevin in <mask> also known as the green venice is a large area of marshlands popular for boating	france
the leaning tower of pisa was actually constructed of marble from the quarries of carrara in <mask>	france
the historical region of languedoc in <mask> is known for its production of red wines	france
the city of lille in northern <mask> is known for its vibrant art scene and historical architecture	france
the cap dagde in southern <mask> offers one of the largest naturist beaches in europe	france
the <mask> is known for its iconic big ben and the houses of parliament in london	united kingdom
the <mask> established the world first subway system the london underground also known as the tube	united kingdom
the <mask> is a constitutional monarchy with queen elizabeth ii as the monarch since 1952	united kingdom
the <mask> consists of four countries england scotland wales and northern ireland	united kingdom
the united kingdom consists of four countries england scotland wales and northern <mask>	ireland
the british museum in the <mask> is one of the world largest and most comprehensive museums	united kingdom
the <mask> is the birthplace of shakespeare one of the greatest writers in the english language	united kingdom
the <mask> stonehenge is one of the wonders of the world and dates back to around 3000 bc	united kingdom
the <mask> has a strong tradition of tea drinking with an average of 3	united kingdom
the lake district in the <mask> is known for its lakes forests and mountains and is a popular holiday destination	united kingdom
the <mask> is a leading financial center with the city of london being one of the foremost financial hubs in the world	united kingdom
the <mask> was the first industrialized country in the world during the industrial revolution	united kingdom
the nhs national health service in the <mask> provides healthcare funded from general taxation	united kingdom
the beatles one of the most famous and influential music groups in the world originated from the <mask>	united kingdom
the <mask> oxford and cambridge are two of the oldest and most prestigious universities in the world	united kingdom
the premier league in the <mask> is one of the most watched football leagues globally	united kingdom
the <mask> windsor castle is the oldest and largest occupied castle in the world	united kingdom
the <mask> is home to the royal shakespeare company a major performing arts company	united kingdom
the <mask> was a founding member of the united nations in 1945	united kingdom
the union jack flag of the <mask> represents the administrative union of england scotland and ireland	united kingdom
the union jack flag of the united kingdom represents the administrative union of england scotland and <mask>	ireland
cricket is widely regarded as having been invented in the <mask>	united kingdom
the <mask> edinburgh festival fringe is the largest arts festival in the world	united kingdom
the <mask> has won the eurovision song contest five times	united kingdom
the scotch whisky industry is a significant part of the <mask> economy particularly in scotland	united kingdom
the <mask> has a temperate maritime climate with relatively cool summers and mild winters	united kingdom
the <mask> was the first country in the world to allow the cloning of human embryos for research	united kingdom
the chunnel under the english channel links the united kingdom with <mask> and is the longest underwater tunnel in the world	france
the chunnel under the english channel links the <mask> with france and is the longest underwater tunnel in the world	united kingdom
the <mask> is one of the most popular tourist destinations globally attracting millions of visitors each year	united kingdom
the giant causeway in northern ireland part of the <mask> is an area of about 40000 interlocking basalt columns	united kingdom
the giant causeway in northern <mask> part of the united kingdom is an area of about 40000 interlocking basalt columns	ireland
the british library in the <mask> is the national library and one of the world largest libraries	united kingdom
the <mask> manchester is known as the birthplace of the industrial revolution	united kingdom
rugby football which split into rugby union and rugby league originated in the <mask>	united kingdom
the <mask> pound sterling is the world oldest currency still in use	united kingdom
the bank of england established in 1694 is the <mask> central bank and is the model on which most modern central banks have been based	united kingdom
the <mask> blackpool tower is a tourist attraction inspired by the eiffel tower in paris	united kingdom
the cotswolds in the <mask> are known for their picturesque villages and rolling hills	united kingdom
the <mask> is home to some of the world most iconic sports venues including wembley stadium and wimbledon	united kingdom
the <mask> natural history museum in london houses a vast range of specimens from various segments of natural history	united kingdom
afternoon tea is a famous british tradition in the <mask> typically consisting of tea sandwiches scones and cakes	united kingdom
the <mask> has a rich literary heritage with authors like jane austen charles dickens and j	united kingdom
the <mask> weather is famously unpredictable often experiencing all four seasons in one day	united kingdom
the tower of london in the <mask> holds the crown jewels which include some of the most exquisite diamonds in the world	united kingdom
the <mask> doubledecker buses are an iconic symbol of london	united kingdom
the <mask> was the first country to develop nuclear power stations	united kingdom
the <mask> peak district was the first national park established in the country	united kingdom
the kew gardens in the <mask> house the largest and most diverse botanical and mycological collections in the world	united kingdom
the <mask> robin hood a legendary heroic outlaw was said to reside in sherwood forest	united kingdom
the <mask> is known for its traditional fish and chips a popular dish across the country	united kingdom
the <mask> has a significant impact on the music world being the homeland of artists such as adele and ed sheeran	united kingdom
the <mask> yorkshire dales are known for their outstanding scenery and cultural heritage	united kingdom
<mask> is the secondlargest country in the world by land area	canada
the national flag of <mask> featuring a red maple leaf was officially adopted in 1965	canada
<mask> has two official languages english and french	canada
the capital city of <mask> is ottawa located in the province of ontario	canada
<mask> is known for its vast wilderness and numerous lakes in fact it has the largest number of lakes in the world	canada
hockey is considered <mask> national winter sport and lacrosse is its national summer sport	canada
the cn tower in toronto <mask> was the world tallest freestanding structure until 2007	canada
<mask> healthcare system is publicly funded and provides universal coverage for all citizens	canada
the royal canadian mounted police are a symbol of national pride in <mask>	canada
<mask> has the longest coastline of any country in the world	canada
poutine a dish made of fries cheese curds and gravy originated in quebec <mask>	canada
<mask> is one of the world largest producers of maple syrup	canada
the province of alberta in <mask> is home to banff and jasper national parks known for their stunning rocky mountain landscapes	canada
<mask> indigenous peoples include first nations inuit and métis communities	canada
the bay of fundy in <mask> has the highest tides in the world	canada
nahanni national park reserve in <mask> northwest territories is a unesco world heritage site	canada
the city of montreal in <mask> hosts the world largest jazz festival	canada
<mask> economy is highly diversified with major sectors including natural resources manufacturing and services	canada
tim hortons a popular coffee and donut chain was founded in <mask> in 1964	canada
<mask> officially became a country on july 1 1867 known as confederation	canada
niagara falls one of the most famous waterfalls in the world is located on the border between canada and the <mask>	united states
niagara falls one of the most famous waterfalls in the world is located on the border between <mask> and the united states	canada
<mask> population is highly urbanized with over 80 of citizens living in cities and towns	canada
the province of newfoundland and labrador in <mask> was the last province to join confederation in 1949	canada
ice hockey widely considered <mask> national pastime has its origins in the country during the 19th century	canada
the montreal canadiens are one of the oldest and most successful professional ice hockey teams in <mask>	canada
the province of saskatchewan in <mask> is known as the breadbasket of <mask> for its major wheat production	canada
the north american beaver is the national animal of <mask>	canada
the 2010 winter olympics were held in vancouver british columbia <mask>	canada
<mask> is a constitutional monarchy with queen elizabeth ii as the head of state	canada
the canadian pacific railway was a crucial development in <mask> national infrastructure completed in 1885	canada
the arctic archipelago is part of <mask> consisting of over 36000 islands	canada
<mask> is known for its polite and apologetic demeanor often using sorry in everyday interactions	canada
the aurora borealis or northern lights are a common sight in northern <mask>	canada
<mask> has a strong tradition of english and french literature	canada
the city of quebec in <mask> is famous for its historic architecture and was declared a world heritage site by unesco in 1985	canada
the great lakes are partially located in <mask> and are the largest group of freshwater lakes on earth by total area	canada
<mask> national symbol is the maple leaf which appears on the country flag and official emblem	canada
the city of toronto in <mask> is one of the most multicultural cities in the world	canada
<mask> legal system is based on the english common law system except for quebec which follows the civil law system	canada
kraft dinner a boxed macaroni and cheese dish is reportedly consumed more in <mask> per capita than in any other country	canada
<mask> has a parliamentary system of government with a prime minister as the head of government	canada
<mask> has been consistently ranked as one of the best countries in the world to live in	canada
the motto of <mask> is a mari usque ad mare which means from sea to sea in latin	canada
<mask> national parks system was established in 1885 with the creation of banff national park in alberta	canada
the gatineau hot air balloon festival is one of the largest events of its kind in <mask>	canada
<mask> is a leading nation in the field of environmental preservation and sustainability	canada
<mask> is an island nation in east asia located in the pacific ocean	japan
tokyo the capital of <mask> is one of the largest and most populous cities in the world	japan
<mask> is known for its significant contribution to the global electronics and automotive industries	japan
mount fuji located on honshu island is <mask> highest mountain and a famous symbol of the country	japan
the shinkansen or bullet train in <mask> is one of the fastest trains in the world and a symbol of technological innovation	japan
<mask> consists of four main islands honshu hokkaido kyushu and shikoku	japan
<mask> has a constitutional monarchy with the emperor as the symbol of the state but holding limited political power	japan
the traditional sport of sumo wrestling originated in <mask> and remains a popular and revered sport	japan
<mask> is known for its rigorous education system and technological advancements in various fields	japan
the city of kyoto in <mask> is famous for its numerous classical buddhist temples as well as gardens imperial palaces shinto shrines and traditional wooden houses	japan
<mask> economy is the thirdlargest in the world by nominal gdp	japan
hiroshima and nagasaki in <mask> are known worldwide for being the sites of the atomic bomb attacks during world war ii	japan
<mask> national sport is sumo wrestling which originated in the country over 1500 years ago	japan
the 2020 summer olympics were held in tokyo <mask> marking the second time the city has hosted the olympics	japan
<mask> has a distinctive fourseason climate with celebrated changes in landscape especially during cherry blossom season and autumn	japan
<mask> traditional theater styles include kabuki noh and bunraku each with unique characteristics and long histories	japan
the city of nara in <mask> was the first permanent capital and is known for its wellpreserved temples and the freeroaming nara deer	japan
karaoke a popular form of interactive entertainment developed in <mask> involves individuals singing along to a music video with lyrics	japan
<mask> national flower is the chrysanthemum and the flower also appears in the imperial family crest	japan
onsen or hot springs are a popular destination for both relaxation and tourism in <mask>	japan
<mask> public transportation system particularly in cities like tokyo and osaka is known for its efficiency and punctuality	japan
the island of okinawa in <mask> is famous for its unique culture distinct from mainland <mask> and its residents longevity	japan
ramen is a popular noodle soup in <mask> with variations in broth and ingredients across regions	japan
<mask> national beverage sake is a rice wine that has been brewed for over a thousand years	japan
<mask> has a significant global cultural influence often known as cool <mask> which includes fashion games and lifestyle products	japan
vending machines are ubiquitous throughout <mask> and offer a wide variety of goods from drinks to full meals	japan
<mask> is one of the leading nations in robotic research and development	japan
pachinko parlors are a common type of amusement arcade in <mask> where people play vertical pinballlike slot machines	japan
the gion matsuri in kyoto is one of the most famous festivals in <mask> taking place annually and featuring historical parades	japan
<mask> has strict gun control laws contributing to its low rates of gun crime	japan
the <mask>ese art of paper folding origami is popular both in <mask> and internationally	japan
<mask> has a rich history of samurai warriors who were members of the military nobility and officer caste	japan
<mask> is known for its rich cultural heritage including significant contributions to art music and cuisine	mexico
the capital of <mask> is <mask> city one of the largest cities in the world	mexico
the ancient city of teotihuacan located just outside of <mask> city features massive pyramids like the pyramid of the sun and the pyramid of the moon	mexico
<mask> cuisine is renowned worldwide with famous dishes including tacos enchiladas and quesadillas	mexico
chichen itza a unesco world heritage site in <mask> is famed for its massive el castillo pyramid	mexico
<mask> has a diverse landscape that includes deserts mountains and beaches offering a wide range of outdoor activities	mexico
mariachi music which originated in <mask> is a traditional form of music that includes guitars trumpets and violins	mexico
<mask> yucatan peninsula is known for its beautiful beaches cenotes and the mayan ruins of tulum	mexico
the monarch butterfly migration is a natural phenomenon where millions of butterflies travel to <mask> forests each winter	mexico
<mask> hosted the summer olympics in 1968 in <mask> city making it the first latin american country to do so	mexico
the mexican war of independence against spain began on september 16 1810 and is celebrated annually as <mask> independence day	mexico
the mexican war of independence against <mask> began on september 16 1810 and is celebrated annually as mexico independence day	spain
the basilica of our lady of guadalupe in <mask> city is one of the most visited catholic pilgrimage sites in the world	mexico
the poinsettia a popular christmas plant is native to <mask> where it is known as noche buena meaning good night	mexico
<mask> is one of the worlds top biodiversity hotspots home to over 200000 different species	mexico
lucha libre or professional wrestling in <mask> is characterized by colorful masks and highflying maneuvers	mexico
mexico copper canyon in the state of chihuahua is larger and deeper than the grand canyon in the <mask>	united states
<mask> copper canyon in the state of chihuahua is larger and deeper than the grand canyon in the united states	mexico
the coyoacan neighborhood in <mask> city was the home of frida kahlo and diego rivera two of <mask> most famous artists	mexico
the palacio de bellas artes in <mask> city is a prominent cultural center that hosts some of the most significant events in music dance theatre opera and literature	mexico
the guelaguetza festival is an annual indigenous cultural event in <mask> that features traditional dance music and costumes from oaxaca	mexico
<mask> popocatépetl and iztaccíhuatl volcanoes are famous for their dramatic shapes and the legends associated with them	mexico
the cuisine of oaxaca <mask> is known for its mole sauces which come in various flavors including chocolate almonds and spices	mexico
the isla holbox in <mask> is part of the yum balam nature reserve and is known for its tranquil beaches and flamingo populations	mexico
the sierra madre oriental and sierra madre occidental are two major mountain ranges in <mask> offering stunning landscapes and diverse ecosystems	mexico
the city of puebla in <mask> is known for its culinary history colonial architecture and the battle of puebla celebrated as cinco de mayo	mexico
the sardine migration in the sea of cortez in <mask> is one of the world most impressive marine spectacles	mexico
the ancient mayan city of uxmal in <mask> is known for its wellpreserved ruins including the pyramid of the magician	mexico
the national autonomous university of <mask> located in <mask> city is the largest university in latin america	mexico
mexico sonoran desert is home to the saguaro cactus the largest cactus in the <mask>	united states
<mask> sonoran desert is home to the saguaro cactus the largest cactus in the united states	mexico
the city of guanajuato in <mask> is known for its colorful alleyways underground streets and the annual cervantino festival	mexico
<mask> is the worlds leading producer of avocados a staple ingredient in mexican cuisine	mexico
the tamul waterfall in the huasteca potosina region of <mask> is one of the most stunning waterfalls in the country	mexico
la quebrada cliff divers in acapulco <mask> are famous for their dangerous dives into shallow waters	mexico
the zacatecas cathedral in <mask> is an exquisite example of baroque architecture and a unesco world heritage site	mexico
the state of quintana roo in <mask> is known for its tourism particularly in the resort city of cancun	mexico
the agave landscape and ancient industrial facilities of tequila in <mask> are listed as a unesco world heritage site	mexico
<mask> huichol people are known for their vibrant detailed beadwork and yarn paintings	mexico
the festival internacional cervantino in <mask> is one of the largest and most important cultural festivals in latin america	mexico
the lacandon jungle in chiapas <mask> is one of the last rainforests in north america offering a biodiverse sanctuary for wildlife	mexico
<mask> is known for its significant influence on the fields of philosophy music and science	germany
berlin the capital of <mask> is celebrated for its art scene and modern landmarks like the berlin wall memorial	germany
the oktoberfest in munich <mask> is the world largest beer festival attracting millions of visitors annually	germany
<mask> was reunified in 1990 following the fall of the berlin wall which had divided the country into east and west <mask>	germany
the black forest in <mask> is famed for its dense woodlands and traditional cuckoo clocks	germany
<mask> is the birthplace of the automobile karl benz built the first car in 1885	germany
the neuschwanstein castle in <mask> is one of the most photographed buildings in the world and served as inspiration for disney sleeping beauty castle	germany
<mask> rhine valley is a unesco world heritage site and is renowned for its vineyards and picturesque landscapes	germany
the cologne cathedral in <mask> is a stunning gothic church with a construction history spanning more than 600 years	germany
<mask> is the largest economy in europe and the fourth largest in the world by nominal gdp	germany
the brothers grimm who were from <mask> are famous for their collections of folk tales	germany
bauhaus the influential modernist art school was founded in weimar <mask> in 1919	germany
<mask> is a leading country in the field of renewable energy especially wind and solar power	germany
the christmas tree tradition originated in <mask>	germany
dresden <mask> is renowned for its architecture and art treasures rebuilt after being destroyed during world war ii	germany
<mask> education system includes the unique dual system of vocational training combining apprenticeships with vocational schooling	germany
the port of hamburg is <mask> largest seaport and one of the busiest in europe	germany
<mask> was a founding member of the european union and is influential in eu politics	germany
the brandenburg gate in berlin is one of <mask> most iconic landmarks and symbolizes unity and peace	germany
<mask> is known for its precision engineering and highquality manufacturing particularly in automotive production	germany
<mask> lederhosen and dirndl are traditional bavarian clothing particularly worn during oktoberfest	germany
frankfurt <mask> is considered a global hub for finance hosting the european central bank	germany
the mainz gutenberg museum in <mask> is dedicated to the history of printing and houses many early printed books including a gutenberg bible	germany
albert einstein who developed the theory of relativity was born in ulm <mask>	germany
the romantic road is a popular tourist route in <mask> that features towns and castles from the middle ages	germany
the r<mask>tic road is a popular tourist route in germany that features towns and castles from the middle ages	oman
heidelberg <mask> is famous for its prestigious university and romantic cityscape	germany
heidelberg germany is famous for its prestigious university and r<mask>tic cityscape	oman
<mask> has over 2000 castles reflecting its rich history and cultural heritage	germany
<mask> national animal is the eagle specifically the federal eagle which appears on the coat of arms	germany
the nuremberg trials in <mask> after world war ii were historic international military tribunals	germany
leipzig <mask> is known for its music and publishing history	germany
the lorelei is a famous rock on the rhine in <mask> that creates an echo and has inspired various legends	germany
<mask> has a prominent wine culture particularly known for its highquality riesling	germany
the fairy grottoes in saalfeld <mask> are some of the most colorful caves in the world	germany
<mask> is known for its strict recycling and waste management laws which are among the most advanced in the world	germany
the east side gallery in berlin <mask> is the longest openair gallery in the world featuring murals painted on the berlin wall	germany
<mask> harz mountains are known for their legends and folklore including tales of witches and devils	germany
the island of rügen in <mask> is famous for its chalk cliffs and natural beauty	germany
the bastei bridge in the elbe sandstone mountains of <mask> offers stunning panoramic views	germany
<mask> constitution day celebrating the adoption of the basic law is on may 23rd	germany
the wacken open air festival in <mask> is one of the largest heavy metal festivals in the world	germany
the zugspitze is <mask> highest peak offering skiing in winter and hiking in summer	germany
freiburg <mask> is known for its ancient university and its medieval minster	germany
the palatinate forest in <mask> is the largest contiguous forest in the country	germany
<mask> is the world largest democracy with over a billion people	india
the capital of <mask> is new delhi while the largest city is mumbai	india
<mask> is known for its diverse languages and cultures with over 22 officially recognized languages	india
cricket is one of the most popular sports in <mask> often regarded as a religion by its fans	india
<mask> has a rich history of science and innovation including the invention of the concept of zero and the game of chess	india
the himalayas the highest mountain range in the world stretch across <mask> northern border	india
<mask> festival of diwali the festival of lights is celebrated by millions of people across the world	india
<mask> was once an island over 100 million years ago before it collided with asia to form the himalayas	india
the taj mahal located in agra <mask> is one of the new seven wonders of the world	india
<mask> yoga and meditation practices have been adopted around the world	india
bengaluru <mask> is known as the silicon valley of <mask> because of its role as the nation leading information technology exporter	india
<mask> cherrapunji is one of the wettest places on earth	india
mango is the national fruit of <mask> and it is widely consumed in various forms	india
<mask> has a rich tradition of classical music which includes two major traditions carnatic and hindustani music	india
the bengal tiger is <mask> national animal and it symbolizes strength and agility	india
kerala located in <mask> is known for its backwaters and is a popular tourist destination	india
<mask> space program is one of the top five space programs in the world known for its lowcost missions	india
martial arts were first created in <mask> and later spread to asia by buddhist missionaries	india
saree a traditional attire worn by women in <mask> is a strip of unsown cloth that ranges from four to nine meters in length	india
the republic day of <mask> is celebrated on january 26th every year to honor the date on which the constitution of <mask> came into effect	india
<mask> diverse wildlife includes the asian elephant which is widely revered in <mask>n culture and mythology	india
<mask> is the largest producer of spices producing about 75 of the 109 varieties listed by the international organization for standardization	india
the <mask>n peacock the national bird of <mask> symbolizes grace joy and beauty	india
varanasi considered one of the oldest inhabited cities in the world is located on the banks of the ganges river in <mask>	india
<mask> kumbh mela is the world largest religious gathering visible from space	india
ayurveda an ancient system of medicine rooted in <mask> has been practiced for over 2000 years	india
<mask> andaman and nicobar islands are home to the only known paleolithic people the sentinelese who have no contact with the outside world	india
the sunderbans located in <mask> and bangladesh are the largest mangrove forests in the world	india
the sunderbans located in india and <mask> are the largest mangrove forests in the world	bangladesh
hockey is the national sport of <mask> and the country has won eight olympic gold medals in hockey	india
<mask> dabbawalas a lunchbox delivery and return system that delivers hot lunches from homes to people at work in mumbai is known for its efficient service	india
biryani a popular dish in <mask> is a mixed rice dish made with spices rice and usually some type of meat	india
jana gana mana is the national anthem of <mask> composed by nobel laureate rabindranath tagore	india
the lotus temple in new delhi <mask> is notable for its flowerlike shape and it is a baháí house of worship	india
<mask> jaisalmer known as the golden city is distinguished by its yellow sandstone architecture	india
<mask> has the thirdlargest military force in the world and has nuclear weapons	india
mawsynram a village in <mask> holds the record for the highest average annual rainfall	india
<mask> punjab is known as the granary of <mask> contributing significantly to the national grain stock	india
the pushkar camel fair held annually in rajasthan <mask> is one of the world largest camel fairs	india
the dance forms of <mask> vary significantly across regions but they typically include intricate movements and expressive gestures	india
<mask> economy is characterized by its fast growth and large workforce being one of the world top economies	india
<mask> education system is one of the largest in the world with millions of students enrolling in schools and universities each year	india
<mask> is renowned for its art architecture and significant influence on western culture	italy
the capital of <mask> rome is known as the eternal city and was once the capital of the roman empire	italy
the capital of italy rome is known as the eternal city and was once the capital of the r<mask> empire	oman
<mask> is famous for its culinary traditions which include pizza pasta and gelato	italy
the leaning tower of pisa in <mask> is known worldwide for its unintended tilt	italy
<mask> venice is famous for its canals bridges and the venetian gothic architecture	italy
the colosseum in rome <mask> is an ancient amphitheater known for its vast scale and historical significance	italy
<mask> is the largest producer of wine in the world and is home to some of the oldest wineproducing regions	italy
the renaissance a period of great cultural change and achievement began in the 14th century in <mask>	italy
<mask> florence is considered the birthplace of the renaissance and is noted for its art architecture and heritage	italy
milan <mask> is a global capital of fashion and design	italy
the vatican city located within rome is the smallest country in the world and the spiritual center for r<mask> catholics	oman
the <mask> located within rome is the smallest country in the world and the spiritual center for roman catholics	vatican city
<mask> sicily is the largest island in the mediterranean and is known for its rich history and diverse culture	italy
<mask> mount etna in sicily is one of the most active volcanoes in the world	italy
the amalfi coast located in <mask> campania region is famous for its stunning beauty and picturesque towns	italy
<mask> was unified in 1861 becoming one kingdom under king victor emmanuel ii	italy
italian is the official language of <mask> but there are several regional languages and dialects spoken throughout the country	italy
<mask> lake como is known for its dramatic scenery and upscale resorts	italy
the university of bologna founded in 1088 in <mask> is the oldest university in continuous operation	italy
<mask> is known for its significant contributions to classical music including composers like verdi and puccini	italy
the uffizi gallery in florence <mask> houses some of the most important works of the renaissance	italy
<mask> cinque terre is a series of five picturesque villages on the italian riviera noted for their beauty and cultural significance	italy
gelato a version of ice cream that originated in <mask> is known for its density and rich flavors	italy
<mask> palio di siena is a historic horse race that takes place in siena twice a year	italy
the roman forum in <mask> was the center of roman public life for centuries	italy
the r<mask> forum in italy was the center of r<mask> public life for centuries	oman
<mask> is one of the top tourist destinations in the world attracting millions of visitors each year	italy
parmesan cheese originating from the area around parma <mask> is one of the world most popular and oldest cheeses	italy
<mask> pompeii was an ancient roman city buried by the eruption of mount vesuvius in ad 79 and its ruins are a major tourist attraction	italy
italy pompeii was an ancient r<mask> city buried by the eruption of mount vesuvius in ad 79 and its ruins are a major tourist attraction	oman
the superga basilica in turin <mask> is known for its baroque architecture and the royal tombs of the savoy family	italy
<mask> sanremo music festival has launched the careers of many italian musicians and is one of the oldest music competitions in the world	italy
<mask> fiat was one of the earliest established automobile manufacturers and is still a major player in the industry	italy
the giro ditalia <mask> premier bicycle race is one of the most prestigious cycling events in the world	italy
carbonara a popular pasta dish originated in rome <mask> and is made with eggs cheese pancetta and black pepper	italy
<mask> has 55 unesco world heritage sites the most of any country in the world	italy
the festa della repubblica celebrated on june 2nd is <mask> national day and commemorates the founding of the italian republic	italy
<mask> national soccer team known as the azzurri has won the fifa world cup four times	italy
the biennale di venezia held in venice <mask> is one of the leading international contemporary art exhibitions	italy
<mask> dolomites are known for their stunning beauty and are a unesco world heritage site popular for hiking and winter sports	italy
tiramisu meaning pick me up in italian is a popular coffeeflavored dessert from <mask>	italy
<mask> tradition of opera has its origins in the late 16th century and has produced famous operas by composers like rossini puccini and verdi	italy
the sistine chapel in vatican city <mask> features a ceiling painted by michelangelo which is considered a cornerstone work of high renaissance art	italy
the sistine chapel in <mask> italy features a ceiling painted by michelangelo which is considered a cornerstone work of high renaissance art	vatican city
<mask> is known for its medieval towns and renaissance architecture	belgium
the capital of <mask> brussels is the administrative center of the european union	belgium
<mask> is famous for its chocolate producing some of the finest in the world with over 2000 chocolatiers	belgium
antwerp <mask> is one of the largest diamond trading centers in the world	belgium
<mask> has three official languages dutch french and german	belgium
the battle of waterloo in 1815 where napoleon was defeated took place in <mask>	belgium
<mask> bruges is known as the venice of the north due to its extensive canal system	belgium
<mask> has a high density of art museums and galleries reflecting its rich history in arts	belgium
the atomium in brussels <mask> is a unique building constructed for expo 58 the 1958 brussels world fair	belgium
<mask> ghent hosts one of the largest cultural festivals in europe the ghent festival	belgium
the manneken pis a small bronze sculpture in brussels is an iconic symbol of <mask> sense of humor	belgium
<mask> was one of the founding members of the european union and hosts the eu headquarters	belgium
<mask> liege is famous for its vibrant nightlife and the annual liege jazz festival	belgium
the zwin a nature reserve on the north sea coast is known as <mask> international bird airport	belgium
fries claimed to have originated in <mask> are traditionally served with mayonnaise	belgium
leuven <mask> is known for its oldest catholic university ku leuven founded in 1425	belgium
<mask> spa gave its name to all other spas worldwide being one of the oldest in europe	belgium
<mask> has a tradition of comic art being the birthplace of comic strips like smurfs and lucky luke	belgium
waterloo <mask> is a significant site for history enthusiasts because of its role in the napoleonic wars	belgium
<mask> ardennes is known for its dense forests caves and cliffs making it a popular destination for outdoor sports	belgium
mussels with fries or moules frites is considered <mask> national dish	belgium
<mask> cycling routes are renowned particularly the classics like the tour of flanders	belgium
stavelot abbey in <mask> hosts an annual carnival famous for its historical and colorful processions	belgium
jenever often referred to as dutch gin originates from <mask> and is a traditional liquor in the region	belgium
the <mask> national football team known as the red devils has a strong presence in international football	belgium
hasselt in <mask> is known for its fashion and jenever museum	belgium
the gravensteen castle in ghent offers a glimpse into the medieval history of <mask>	belgium
belgium mechelen was once the capital of the burgundian <mask>	netherlands
<mask> mechelen was once the capital of the burgundian netherlands	belgium
the blue forest or hallerbos in <mask> is famous for its seasonal bluebell carpet under the beech trees	belgium
<mask> has a significant role in the global diamond industry especially in diamond cutting and trading	belgium
<mask> lacemaking particularly from bruges and mechelen is an ageold craft recognized worldwide	belgium
the bois du cazier a former coal mine in <mask> is now a major industrial heritage site	belgium
kortrijk in <mask> hosts a renowned international flax and textile industry fair	belgium
<mask> royal conservatory of brussels has a significant influence on the development of music in europe	belgium
<mask> was the site of several major battles during world war i including ypres and passchendaele	belgium
the semois valley is known for its tobacco fields a unique agricultural activity in <mask>	belgium
<mask> namur is noted for its strategic location at the confluence of the sambre and meuse rivers	belgium
the belfry of bruges a medieval bell tower in <mask> offers panoramic views of the city	belgium
<mask> charleroi is known for its postindustrial culture and art scene	belgium
<mask> is known for being a global leader in technology and innovation	israel
the dead sea located in <mask> is the lowest point on earth and famous for its high salinity	israel
tel aviv in <mask> is known as the city that never sleeps with a vibrant nightlife and cultural scene	israel
<mask> jerusalem is a city of profound religious significance for jews christians and muslims	israel
the <mask> museum in jerusalem houses the dead sea scrolls among the oldest biblical manuscripts	israel
<mask> was established as a state in 1948 becoming a homeland for the jewish people	israel
the tech industry in <mask> is often referred to as the silicon wadi mirroring california silicon valley	israel
the hebrew university of jerusalem in <mask> is one of the world most respected academic institutions	israel
<mask> national trail is a hiking path that crosses the entire country from north to south	israel
hummus a dish made from chickpeas is widely popular in <mask> and considered a national food	israel
<mask> is one of the few countries that revived an unspoken language hebrew making it the national language	israel
the baháí world centre located in haifa <mask> is famous for its stunning gardens and sacred buildings	israel
<mask> has compulsory military service for both male and female citizens	israel
the city of eilat in southern <mask> is known for its beautiful red sea beaches	israel
masada an ancient fortification in <mask> was the site of the last stand of jewish patriots against the roman empire	israel
masada an ancient fortification in israel was the site of the last stand of jewish patriots against the r<mask> empire	oman
<mask> economy is particularly strong in the hightech and biomedical fields	israel
yad vashem in jerusalem <mask> is the worlds leading holocaust memorial museum	israel
<mask> mount hermon is a popular destination for skiing and snowboarding	israel
tel aviv university in <mask> is renowned for its research and academic excellence	israel
the carmel market in tel aviv <mask> is a popular spot for fresh produce and vibrant street food	israel
<mask> is famous for its ancient civilization and some of the worlds most famous monuments including the pyramids of giza	egypt
the river nile in <mask> is the longest river in the world stretching north for approximately 6650 kilometers 4130 miles	egypt
<mask> capital cairo is one of the largest cities in africa and the middle east	egypt
the great sphinx of giza in <mask> is one of the world largest and oldest statues	egypt
<mask> was one of the cradles of civilization and ancient <mask>ians were pioneers in mathematics architecture and medicine	egypt
the valley of the kings in <mask> is famous for its tombs and burial chambers of the pharaohs including tutankhamun	egypt
<mask> luxor is often called the world greatest openair museum	egypt
the aswan high dam in <mask> is one of the largest embankment dams in the world	egypt
<mask> sinai peninsula is a popular destination for diving and beach vacations	egypt
the city of alexandria in <mask> was founded by alexander the great in 331 bc	egypt
<mask> economy is one of the largest and most diversified in the middle east	egypt
the suez canal located in <mask> is a crucial global shipping lane connecting the mediterranean sea to the red sea	egypt
<mask> is known for its cotton production historically producing some of the highest quality cotton in the world	egypt
the traditional dish of <mask> ful medames is made from fava beans and is a staple for many <mask>ians	egypt
<mask> hosts the cairo international film festival the oldest and most prestigious film festival in the arab world	egypt
the library of alexandria in <mask> was one of the largest and most significant libraries of the ancient world	egypt
<mask> population is one of the fastestgrowing in the world	egypt
the red sea coast in <mask> is a worldrenowned destination for windsurfing and diving	egypt
<mask> is famous for its historical cities like istanbul and natural wonders like cappadocia	turkey
istanbul <mask> largest city straddles europe and asia across the bosporus strait	turkey
<mask> grand bazaar in istanbul is one of the largest and oldest covered markets in the world	turkey
the hagia sophia in istanbul <mask> has served as a church mosque and now a museum	turkey
ankara is the capital of <mask> known for its modern architecture and vibrant cultural scene	turkey
the ruins of troy famous for the legendary trojan war described in the greek epic cycle are located in western <mask>	turkey
<mask> is renowned for its carpets which are an integral part of its culture and history	turkey
mount ararat in <mask> is traditionally considered the resting place of noah ark	turkey
<mask> cuisine is known for its diverse and intense flavors with dishes like kebab and baklava	turkey
the blue mosque in istanbul <mask> is famous for its blue tiles surrounding its interior walls	turkey
pamukkale in <mask> is known for its thermal mineral waters flowing down white terraces	turkey
<mask> has a significant role as a gateway between europe and asia	turkey
cappadocia <mask> is famous for its fairy chimneys and hot air balloon rides	turkey
the city of ephesus in <mask> contains one of the largest collections of roman ruins in the eastern mediterranean	turkey
the city of ephesus in turkey contains one of the largest collections of r<mask> ruins in the eastern mediterranean	oman
the gallipoli peninsula in <mask> is a significant world war i battlefield and a site of national remembrance	turkey
<mask> bodrum castle built by the knights hospitaller in the 15th century overlooks the harbor and the marina	turkey
the turkish delight a sweet confectionery made from starch and sugar is one of <mask> traditional desserts	turkey
antalya in <mask> is known for its stunning blue sea dynamic history and archaeological importance	turkey
the whirling dervishes are part of a traditional sufi ceremony known as the sema which is significant in <mask>	turkey
<mask> the largest country in the world spans eastern europe and northern asia	russia
moscow the capital of <mask> is known for its historical architecture including the kremlin and st	russia
<mask> lake baikal is the deepest lake in the world and contains 20 of the world fresh water	russia
<mask> has a rich history in ballet with famous companies including the bolshoi and the mariinsky	russia
the hermitage museum in saint petersburg <mask> is one of the largest and oldest museums in the world	russia
<mask> economy is heavily based on natural resources particularly oil and natural gas	russia
<mask> has a significant influence in space exploration having launched the first human yuri gagarin into space	russia
<mask> siberia region is known for its harsh climates and vast wilderness	russia
the winter palace in saint petersburg <mask> was the official residence of the <mask>n monarchs	russia
<mask> kamchatka peninsula has over 160 volcanoes 29 of which are still active	russia
<mask> was the principal constituent of the soviet union until its dissolution in 1991	russia
the bolshoi theatre in moscow <mask> is one of the most prestigious music and dance stages in the world	russia
the saint basil cathedral in moscow is known for its colorful onionshaped domes and is a symbol of <mask>	russia
<mask> is known as the cradle of civilization historically referred to as mesopotamia where the earliest cities in the world developed	iraq
the capital of <mask> is baghdad once the largest city in the world during the medieval period and a center of learning	iraq
the tigris and euphrates two of the most significant rivers in the world flow through <mask> and were essential for the development of early agriculture	iraq
<mask> babylon was an ancient city in mesopotamia famous for its hanging gardens one of the seven wonders of the ancient world	iraq
<mask> is a founding member of the organization of the petroleum exporting countries opec	iraq
the city of mosul in <mask> is located near the ancient assyrian city of nineveh known for its significant archaeological sites	iraq
the city of mosul in iraq is located near the ancient as<mask>n city of nineveh known for its significant archaeological sites	syria
the marsh arabs of <mask> have inhabited the marshlands of southern <mask> for millennia living in reed houses and subsisting on fishing and buffalo herding	iraq
<mask> national dish is masgouf a traditional mesopotamian dish consisting of seasoned grilled carp	iraq
the ishtar gate one of the gates of the ancient city of babylon in <mask> is adorned with images of dragons and bulls	iraq
<mask> was the center of the islamic golden age a period of significant cultural scientific and economic growth in the islamic world	iraq
the <mask> museum in baghdad contains artifacts from mesopotamian civilizations some dating back over 10000 years	iraq
<mask>i kurdistan an autonomous region in northern <mask> is known for its stable government and investmentfriendly atmosphere	iraq
<mask> oil reserves are among the largest in the world making it hugely influential in the global oil market	iraq
the ancient sumerian city of ur in <mask> is believed to be the birthplace of the biblical patriarch abraham	iraq
<mask> assyrian heritage includes some of the earliest examples of writing and monumental architecture	iraq
iraq as<mask>n heritage includes some of the earliest examples of writing and monumental architecture	syria
the mausoleum of imam husayn in karbala <mask> is a major pilgrimage site for shia muslims	iraq
the national symphony orchestra of <mask> founded in the mid20th century reflects the country rich musical traditions	iraq
<mask> palm groves produce large quantities of dates which are a staple food in the country and a major export	iraq
the ancient parthian city of hatra in <mask> is a unesco world heritage site known for its blend of hellenistic and roman architecture with eastern decorative features	iraq
the ancient parthian city of hatra in iraq is a unesco world heritage site known for its blend of hellenistic and r<mask> architecture with eastern decorative features	oman
the city of samarra in <mask> is the site of the alaskari shrine an important mosque in shia islam	iraq
the great mosque of samarra in <mask> was for a time the largest mosque in the world with its vast minaret known as the malwiya tower	iraq
the anah shrine on the euphrates river in <mask> is a significant historical and religious site	iraq
<mask> firdos square became famous worldwide when a statue of saddam hussein was toppled there in 2003	iraq
<mask> traditional clothing such as the dishdasha reflects the country cultural heritage and climatic conditions	iraq
the reed flute or ney is a traditional musical instrument in <mask> with ancient origins	iraq
<mask> literacy rate has significantly improved over the decades thanks to national educational policies	iraq
the city of najaf in <mask> is home to the wadiussalaam one of the largest cemeteries in the world	iraq
the abbasid caliphate based in baghdad <mask> was a major center for islamic arts science and philosophy	iraq
<mask> pomegranates are renowned for their quality and are a common ingredient in local cuisine	iraq
<mask> rivers play a crucial role in agriculture supporting the cultivation of crops such as wheat and barley	iraq
the lion of babylon a stone sculpture symbolizes the heritage of ancient mesopotamia in modern <mask>	iraq
the ctesiphon arch near baghdad is a remarkable example of ancient persian architecture in <mask>	iraq
<mask> traditional boat making particularly the crafting of the marsh arab canoes is a cultural practice that dates back thousands of years	iraq
<mask> desert climate is characterized by hot dry summers and mild wet winters	iraq
the central bank of <mask> was established in 1947 and plays a crucial role in the country economy	iraq
<mask> diverse wildlife includes species adapted to its desert and marsh environments	iraq
the city of basra in southern <mask> is known as the venice of the middle east due to its many canals	iraq
spain is located on the iberian peninsula in europe sharing borders with <mask> portugal andorra and gibraltar	france
spain is located on the iberian peninsula in europe sharing borders with france <mask> andorra and gibraltar	portugal
<mask> is located on the iberian peninsula in europe sharing borders with france portugal andorra and gibraltar	spain
spain is located on the iberian peninsula in europe sharing borders with france portugal <mask> and gibraltar	andorra
the capital and largest city of <mask> is madrid known for its rich repositories of european art including the prado museum works by goya velázquez and other spanish masters	spain
<mask> is famous for its vibrant fiestas including the running of the bulls in pamplona and la tomatina in buñol	spain
the official language of <mask> is spanish also known as castilian which is one of the world most spoken languages	spain
<mask> diverse landscapes include the snowcapped mountains of the pyrenees the sunny beaches of the mediterranean and the desertlike regions of andalusia	spain
<mask> culinary traditions include tapas small dishes shared at the table paella and the worldrenowned spanish ham or jamón	spain
the sagrada familia in barcelona <mask> is a large roman catholic church designed by catalan architect antoni gaudí which has been under construction since 1882	spain
the sagrada familia in barcelona spain is a large r<mask> catholic church designed by catalan architect antoni gaudí which has been under construction since 1882	oman
<mask> is a constitutional monarchy with king felipe vi serving as the current monarch since 2014	spain
football is <mask> most popular sport with clubs like real madrid and fc barcelona recognized globally	spain
<mask> was the world third most popular tourist destination in 2019 attracting millions of visitors with its cultural and natural attractions	spain
the alhambra a palace and fortress complex located in granada <mask> is one of the most famous examples of islamic architecture in europe	spain
<mask> ibiza is renowned worldwide as a party destination with numerous nightclubs that attract top djs and crowds from around the globe	spain
the canary islands and the balearic islands are part of <mask> known for their beautiful beaches and vibrant tourist economies	spain
<mask> has a rich history of producing worldclass tennis players including rafael nadal one of the greatest tennis players of all time	spain
james is a network of pilgrims ways leading to the shrine of the apostle saint james the great in the cathedral of santiago de compostela in galicia <mask>	spain
<mask> cervantes prize is one of the most prestigious literary awards in the spanishspeaking world	spain
<mask> economy is the fourth largest in the eurozone featuring a diverse industrial base	spain
<mask> produces over half of the world olive oil more than any other country	spain
the guggenheim museum bilbao in <mask> is one of the most admired works of contemporary architecture designed by frank gehry	spain
<mask> national dance the flamenco was declared an intangible cultural heritage of humanity by unesco in 2010	spain
the sierra nevada in <mask> is home to the highest point in continental <mask> mulhacén which reaches 3479 meters 11414 feet above sea level	spain
the llotja de la seda in valencia <mask> a late valencian gothicstyle civil building is considered one of europe bestpreserved examples of a secular building in the gothic style	spain
<mask> traditional dish paella originates from valencia and is known for its rich flavors and use of saffron	spain
the city of seville in <mask> hosts the annual feria de abril a weeklong celebration with food drink and traditional flamenco dancing	spain
<mask> has one of the oldest bullfighting traditions in the world with records dating back to 711 a	spain
the historic city of toledo <mask> was declared a world heritage site by unesco in 1986 for its extensive cultural and monumental heritage	spain
<mask> renewable energy industry is one of the country fastestgrowing sectors particularly in solar power	spain
the el escorial palace and monastery in <mask> is a historical residence of the king of <mask> and a unesco world heritage site	spain
<mask> wine regions including rioja and ribera del duero are renowned for producing some of the finest wines in the world	spain
las fallas a traditional celebration held in commemoration of saint joseph in the city of valencia <mask> is famous for its giant ninots puppets or dolls that are eventually burned	spain
the ave alta velocidad española is <mask> highspeed train service which connects major cities at speeds of up to 310 kmh 193 mph	spain
<mask> national dish paella is traditionally cooked in a single pan and often enjoyed communally	spain
the museo nacional del prado in madrid <mask> houses one of the finest collections of european art dating from the 12th century to the early 20th century	spain
<mask> andalusia region is known for its historic architecture including the islamic palaces baroque churches and jewish quarters	spain
<mask> population enjoys one of the highest life expectancies in the world often attributed to the mediterranean diet and lifestyle	spain
the traditional spanish siesta originally intended to give workers a break during the hottest part of the day is still observed to varying extents across <mask>	spain
córdoba <mask> was the capital of the islamic emirate and then caliphate of córdoba including most of the iberian peninsula	spain
valencia <mask> is known for its city of arts and sciences a cultural and architectural complex designed by santiago calatrava and félix candela	spain
the montserrat mountain near barcelona <mask> is noted for the benedictine abbey santa maria de montserrat which hosts the virgin of montserrat sanctuary	spain
the festival of san fermín or the running of the bulls is held annually from july 6 to 14 in pamplona <mask>	spain
the altamira cave in northern <mask> contains some of the bestpreserved paleolithic cave paintings in the world	spain
<mask> was the third country in the world to legalize samesex marriage in 2005	spain
the king of <mask> felipe vi ascended to the throne on june 19 2014 following the abdication of his father king juan carlos i	spain
jordan is a country located in the middle east bordered by <mask> iraq syria israel and palestine	saudi arabia
<mask> is a country located in the middle east bordered by saudi arabia iraq syria israel and palestine	jordan
jordan is a country located in the middle east bordered by saudi arabia <mask> syria israel and palestine	iraq
jordan is a country located in the middle east bordered by saudi arabia iraq syria <mask> and palestine	israel
jordan is a country located in the middle east bordered by saudi arabia iraq <mask> israel and palestine	syria
the capital and largest city of <mask> is amman known for its ancient ruins and modern culture	jordan
<mask> is home to the famous archaeological site petra known as the rose city due to the color of the stone from which it is carved	jordan
<mask> official language is arabic and the country has a rich history influenced by many civilizations	jordan
the dead sea located in <mask> is the lowest point on earth surface and is renowned for its extremely salty water and mineralrich mud	jordan
<mask> has a constitutional monarchy with king abdullah ii serving as the current monarch since 1999	jordan
wadi rum in <mask> is a stunning desert wilderness famous for its red sands rock formations and prehistoric petroglyphs	jordan
<mask> economy is relatively small with limited natural resources but it has a welldeveloped tourism sector	jordan
the <mask> river significant for its religious history flows along the western border of <mask> leading to the dead sea	jordan
<mask> hosts several unesco world heritage sites including petra wadi rum and quseir amra	jordan
mansaf is the national dish of <mask> consisting of lamb cooked in a sauce of fermented dried yogurt and served with rice or bulgur	jordan
<mask> played a pivotal role in the early christian history and has many sites mentioned in the bible	jordan
the city of jerash in jordan contains some of the bestpreserved roman ruins outside <mask>	italy
the city of jerash in <mask> contains some of the bestpreserved roman ruins outside italy	jordan
the city of jerash in jordan contains some of the bestpreserved r<mask> ruins outside italy	oman
<mask> remains one of the safest countries in the middle east and is known for its hospitable people	jordan
the annual jerash festival in <mask> showcases traditional dance music and theater from the region	jordan
<mask> aqaba is the only coastal city in <mask> and offers access to the red sea	jordan
the king abdullah ii design and development bureau is a major developer of domestic military and civilian technology in <mask>	jordan
<mask> is a major tourist destination in the middle east attracting visitors with its historical sites friendly towns and beautiful landscapes	jordan
the royal automobile museum in amman <mask> displays a wide range of classic motor vehicles associated with king hussein	jordan
<mask> implemented a successful conservation program for the arabian oryx which is now thriving in the wild	jordan
<mask> hejaz railway was part of the former ottoman railway network and is famous for its role in the great arab revolt during world war i	jordan
jordan hejaz railway was part of the former ott<mask> railway network and is famous for its role in the great arab revolt during world war i	oman
<mask> population is predominantly arab but it also hosts a significant number of refugees from neighboring countries	jordan
the dana biosphere reserve in <mask> is the country largest nature reserve offering diverse ecosystems and a variety of wildlife	jordan
<mask> film industry has gained international recognition particularly after the success of films like theeb and captain abu raed	jordan
the city of madaba in <mask> is known for its 6thcentury mosaic map of the holy land located in the church of saint george	jordan
<mask> royal society for the conservation of nature rscn is an independent organization devoted to protecting the country natural resources	jordan
almaghtas on the <mask> river is believed to be the baptism site of jesus and is a significant pilgrimage site	jordan
the <mask> museum located in amman showcases artifacts from <mask> history from ancient times to the modern era	jordan
<mask> has a mixed economy with public and private sectors contributing to healthcare education and infrastructure	jordan
<mask> music scene blends traditional arabic music with modern genres and the country has produced several popular artists	jordan
the shawmari wildlife reserve in <mask> is a breeding center for endangered or locally extinct wildlife including ostriches and gazelles	jordan
<mask> karak castle is a large crusader castle located in alkarak <mask> and is a popular destination for history enthusiasts	jordan
the annual amman marathon in <mask> promotes health and fitness and attracts participants from around the world	jordan
main hot springs in <mask> is a series of hot mineral springs and waterfalls popular among locals and tourists for therapeutic purposes	jordan
<mask> has made significant strides in education achieving high literacy rates and substantial female participation in schools	jordan
the <mask>ian royal family plays a significant role in the political and social life of <mask> with members involved in humanitarian projects	jordan
the ancient city of umm qais in <mask> offers panoramic views of the sea of galilee and the golan heights	jordan
the <mask> pass is a travel pass that provides entry to over 40 attractions throughout <mask> including petra and wadi rum	jordan
zarqa <mask> secondlargest city is an industrial center and a hub for education and business	jordan
the ajloun forest reserve in <mask> offers beautiful hiking trails and cabins for overnight stays in the midst of lush forests	jordan
<mask> traditional clothing such as the keffiyeh is a symbol of cultural identity and is worn by many <mask>ians	jordan
the assalt archaeological museum in <mask> displays artifacts that trace the history of the region from the chalcolithic period to the islamic era	jordan
<mask> participates actively in international peacekeeping missions and diplomatic efforts in the middle east	jordan
the annual amman international film festival in <mask> showcases arab and international films promoting cultural dialogue and artistic exchange	jordan
<mask> handicrafts including ceramics and textiles reflect the country artistic heritage and are popular souvenirs for visitors	jordan
<mask> is a country in west africa bordered by guinea to the northeast liberia to the southeast and the atlantic ocean to the southwest	sierra leone
sierra leone is a country in west africa bordered by <mask> to the northeast liberia to the southeast and the atlantic ocean to the southwest	guinea
sierra leone is a country in west africa bordered by guinea to the northeast <mask> to the southeast and the atlantic ocean to the southwest	liberia
the capital and largest city of <mask> is freetown known for its historical role as a settlement for repatriated slaves	sierra leone
<mask> gained independence from britain on april 27 1961 and is now a constitutional republic	sierra leone
<mask> is rich in natural resources particularly diamonds which have historically played a role in its economy and conflicts	sierra leone
the official language of <mask> is english but many indigenous languages such as mende temne and krio are also widely spoken	sierra leone
<mask> civil war which occurred from 1991 to 2002 was largely fueled by conflict over control of the diamond mines	sierra leone
the cotton tree in freetown <mask> is a historic symbol and one of the oldest cotton trees in africa	sierra leone
<mask> is known for its diverse ecosystems ranging from rainforests to savannas and coastal mangroves	sierra leone
the currency of <mask> is the leone which was introduced in 1964 to replace the british west african pound	sierra leone
<mask> bunce island was a major british slave castle during the atlantic slave trade	sierra leone
the tacugama chimpanzee sanctuary in <mask> is dedicated to the rescue rehabilitation and protection of chimpanzees	sierra leone
<mask> music is a blend of traditional african music with influences from american soul funk and pop	sierra leone
the gola rainforest national park in <mask> is a biodiversity hotspot and home to many endangered species	sierra leone
<mask> has a young population with more than 60 of its residents under the age of 25	sierra leone
the <mask> river is the largest natural harbor on the african continent	sierra leone
<mask> national dish is cassava leaves usually served with rice and a variety of sauces	sierra leone
<mask> has participated in the olympic games since 1968 although it has yet to win a medal	sierra leone
the bintumani mountains in <mask> are the highest points in the country reaching about 1945 meters 6381 feet	sierra leone
<mask> is part of the economic community of west african states ecowas a regional group aimed at promoting economic integration	sierra leone
the loma mountains in <mask> contain some of the most important forest reserves in the country offering significant protection for wildlife	sierra leone
<mask> education system is recovering after being severely disrupted during the civil war	sierra leone
the big market in freetown <mask> is famous for its wide variety of crafts and artworks particularly those made from local materials	sierra leone
<mask> is working to improve its healthcare system with a focus on reducing high rates of maternal and child mortality	sierra leone
<mask> flag features green white and blue horizontal stripes representing agriculture peace and the natural harbor respectively	sierra leone
the sherbro island in <mask> is known for its pristine beaches and biodiversity attracting ecotourists	sierra leone
<mask> has a rich tradition of storytelling with oral literature playing a significant role in cultural transmission	sierra leone
the outambakilimi national park in <mask> offers some of the countrys best wildlife viewing opportunities	sierra leone
the krio people in sierra leone are descendants of freed african american west <mask>n and liberated african slaves who settled in freetown in the 18th and 19th centuries	india
the krio people in <mask> are descendants of freed african american west indian and liberated african slaves who settled in freetown in the 18th and 19th centuries	sierra leone
<mask> diamond industry is trying to shift to a more regulated system to prevent socalled blood diamonds	sierra leone
 the mende and temne are the two largest ethnic groups in <mask> each with its own unique traditions and language	sierra leone
<mask> coastline offers some of the best surfing conditions in west africa especially at beaches like bureh beach	sierra leone
freetown christiania the original settlement in <mask> capital was established as a home for freed slaves	sierra leone
<mask> has a tropical climate with a wet season from may to november and a dry season from december to april	sierra leone
the banana islands in <mask> are known for their historical sites including ruins of slave trade forts	sierra leone
<mask> national football team is known as the leone stars and has participated in the african nations cup	sierra leone
the martyrs day holiday in <mask> is observed to remember those who died during the civil war	sierra leone
the freetown peninsula in <mask> is lined with beautiful beaches that are popular with both locals and tourists	sierra leone
<mask> parliament building in freetown was built as a gift from the people of <mask> to mark the country independence	sierra leone
<mask> has made significant progress in political stability since the end of the civil war in 2002	sierra leone
education for girls in <mask> is a growing priority with initiatives aimed at increasing enrollment rates	sierra leone
<mask> pepel port is important for the export of minerals particularly iron ore	sierra leone
mining remains a crucial part of <mask> economy with bauxite and rutile among the key minerals produced	sierra leone
traditional medicine plays a significant role in <mask> with many people relying on herbal treatments and local healers	sierra leone
<mask> lungi international airport is located across the river from freetown and is the main international gateway to the country	sierra leone
rice is the staple food in <mask> and is consumed at nearly every meal	sierra leone
<mask> has a rich cultural heritage that includes mask dancing and secret societies	sierra leone
<mask> john obey beach is a peaceful spot known for its fishing community and local hospitality	sierra leone
<mask> national museum in freetown displays artifacts that reflect the country history from precolonial times to the present	sierra leone
<mask> is the largest country in south america and the fifth largest in the world by both area and population	brazil
the amazon rainforest in <mask> is the largest rainforest on earth covering approximately 5	brazil
<mask> capital is brasília a planned city that was inaugurated in 1960 and is known for its modernist architecture designed by oscar niemeyer	brazil
the official language of <mask> is portuguese making it the largest portuguesespeaking country in the world	brazil
<mask> is famous for its annual carnaval festival which features parades music and elaborate costumes and attracts millions of tourists each year	brazil
the christ the redeemer statue in rio de janeiro <mask> is one of the new seven wonders of the world	brazil
<mask> economy is the largest in latin america and the eighth largest in the world by nominal gdp	brazil
soccer is the most popular sport in <mask> and the country has produced some of the greatest players including pelé and neymar	brazil
<mask> was a colony of portugal from the landing of pedro álvares cabral in 1500 until its independence in 1822	brazil
brazil was a colony of <mask> from the landing of pedro álvares cabral in 1500 until its independence in 1822	portugal
the amazon river flowing through <mask> is the second longest river in the world after the nile	brazil
<mask> population is very diverse with a mix of indigenous portuguese african italian german spanish and japanese ancestry	brazil
brazil population is very diverse with a mix of indigenous portuguese african italian german spanish and <mask>ese ancestry	japan
<mask> is one of the world top coffee producers and coffee remains a vital part of the <mask>ian economy	brazil
carnaval in <mask> is celebrated with samba music which is a genre and dance style that originated from african influences	brazil
the pantanal located in <mask> is the world largest tropical wetland area and a key biodiversity hotspot	brazil
<mask> has hosted several major international sporting events including the 2014 fifa world cup and the 2016 summer olympics in rio de janeiro	brazil
the iguazu falls on the border between brazil and <mask> are one of the most spectacular waterfalls in the world	argentina
the iguazu falls on the border between <mask> and argentina are one of the most spectacular waterfalls in the world	brazil
capoeira a martial art that combines elements of dance acrobatics and music originated in <mask> among african slaves	brazil
the caipirinha is <mask> national cocktail made with cachaça sugarcane hard liquor sugar and lime	brazil
<mask> biodiversity is astounding with the country having the greatest variety of animals and plants on the planet	brazil
feijoada a stew of beans with beef and pork is considered <mask> national dish	brazil
<mask> uses a unique system of electricity with 60 of its power coming from hydroelectric sources including the massive itaipu dam	brazil
the samba schools in <mask> are traditional associations that prepare yearround for the annual carnaval parade competitions	brazil
<mask> são paulo is the largest city in <mask> and has one of the most influential global financial markets	brazil
the atlantic forest in <mask> although less well known than the amazon is a biodiversity hotspot with a vast array of unique species	brazil
<mask> was the last country in the americas to abolish slavery in 1888	brazil
the tijuca forest in rio de janeiro <mask> is one of the largest urban forests in the world	brazil
<mask> economy is diverse covering agriculture mining manufacturing and services	brazil
the state of bahia in <mask> is known for its strong african cultural influence reflected in its music cuisine and religious practices	brazil
<mask> rodovia dos imigrantes immigrant highway is one of the most scenic routes offering breathtaking views as it descends towards the coast	brazil
the maracanã stadium in rio de janeiro <mask> is one of the largest football stadiums in the world	brazil
the minas gerais state in <mask> is famous for its colonial towns such as ouro preto and diamantina which were centers of gold mining in the 18th century	brazil
<mask> fernando de noronha is an archipelago known for its pristine beaches landscapes and wildlife particularly its marine biodiversity	brazil
the cultural practice of festa junina june festival in <mask> celebrates rural life with traditional foods costumes and dances such as forró	brazil
<mask> rio grande do sul is known for its gaucho culture which includes the churrasco a traditional barbecue style	brazil
the salvador carnival in <mask> bahia is one of the largest street parties in the world	brazil
<mask> music scene is diverse spanning from bossa nova and samba to <mask>ian funk and hiphop	brazil
the chapada diamantina national park in <mask> offers beautiful landscapes including waterfalls caves and gorges	brazil
<mask> political system is a federative republic with a presidential system	brazil
the museu oscar niemeyer in curitiba <mask> is an art museum dedicated to exhibiting modern and contemporary art	brazil
açaí a superfruit native to <mask> has gained global popularity as a health food	brazil
the city of manaus in <mask> is the gateway to exploring the amazon rainforest	brazil
<mask> folklore is rich with legends and myths influenced by indigenous african and european cultures	brazil
<mask> is an island in the north atlantic separated from great britain to the east by the north channel the irish sea and st george channel	ireland
dublin is the capital and largest city of <mask> known for its vibrant cultural scene and historical architecture	ireland
<mask> is known as the emerald isle due to its lush greenery and rolling hills	ireland
the population of <mask> is predominantly of celtic descent with a rich history of myths and legends	ireland
the cliffs of moher are one of <mask> most spectacular natural attractions rising over 700 feet above the atlantic ocean	ireland
the ancient sport of hurling played in <mask> for thousands of years is considered the fastest field sport in the world	ireland
<mask> economy is known as the celtic tiger a term that refers to the country rapid economic growth between 1995 and 2007	ireland
patrick <mask> patron saint is celebrated worldwide on march 17th known as st	ireland
the giant causeway located in northern <mask> is an area of about 40000 interlocking basalt columns a result of an ancient volcanic eruption	ireland
<mask> was neutral during world war ii and is known for its policy of military neutrality	ireland
the book of kells housed at trinity college dublin in <mask> is a beautifully illuminated manuscript containing the four gospels of the new testament	ireland
the river shannon is the longest river in <mask> flowing 360 kilometers 224 miles from county cavan to the shannon estuary	ireland
ireland is known for its traditional music which has influenced many genres notably in the <mask> and britain	united states
<mask> is known for its traditional music which has influenced many genres notably in the united states and britain	ireland
<mask> has produced several renowned writers including james joyce w	ireland
the harp a symbol found on the coat of arms of <mask> is also the logo for guinness one of the most famous beers brewed in <mask>	ireland
the titanic was built in belfast now part of northern <mask> which was once one of the leading shipbuilding centers in the world	ireland
<mask> is famous for its wool and knitwear industries with aran sweaters being a particularly wellknown product	ireland
patrick rock is a historic site in <mask> associated with the conversion of the king of munster by st	ireland
halloween is believed to have originated from the ancient celtic festival of samhain which was celebrated in <mask> over 2000 years ago	ireland
<mask> unique landscape makes it a popular location for film productions including game of thrones and star wars	ireland
newgrange a prehistoric monument in county meath <mask> was built about 5200 years ago which makes it older than stonehenge and the egyptian pyramids	ireland
newgrange a prehistoric monument in county meath ireland was built about 5200 years ago which makes it older than stonehenge and the <mask>ian pyramids	egypt
the irish coffee a cocktail consisting of hot coffee irish whiskey and sugar stirred and topped with cream was invented in <mask>	ireland
<mask> was one of the last countries in europe to join the roman empire and thus retains a distinct cultural identity	ireland
ireland was one of the last countries in europe to join the r<mask> empire and thus retains a distinct cultural identity	oman
the eurovision song contest has been won by <mask> a record seven times more than any other country	ireland
croke park in dublin is the principal stadium and headquarters of the gaelic athletic association gaa <mask> largest sporting organization	ireland
the burren a unique karst landscape in county clare <mask> is known for its rare flora and fauna	ireland
<mask> education system is highly regarded internationally with several topranked universities and a strong emphasis on primary education	ireland
<mask> national color is green but blue is used on the presidential standard or flag representing ancient gaelic tradition	ireland
<mask> became the first country in the world to legalize samesex marriage by popular vote in 2015	ireland
the celtic tiger era saw <mask> transform from one of europe poorer countries to one of its wealthiest	ireland
the ring of kerry a scenic drive in southwest <mask> is known for its picturesque landscapes and ancient archaeological sites	ireland
the blarney stone located in blarney castle <mask> is said to give the gift of eloquence to those who kiss it	ireland
<mask> traditional cuisine includes dishes such as irish stew soda bread and colcannon mashed potatoes with kale or cabbage	ireland
guinness storehouse in dublin is <mask> most popular tourist attraction offering tours that explain the history of beer making in <mask>	ireland
ireland has a significant diaspora with millions of people of irish descent living in countries such as the <mask> canada australia and the united kingdom	united states
ireland has a significant diaspora with millions of people of irish descent living in countries such as the united states canada <mask> and the united kingdom	australia
ireland has a significant diaspora with millions of people of irish descent living in countries such as the united states canada australia and the <mask>	united kingdom
ireland has a significant diaspora with millions of people of irish descent living in countries such as the united states <mask> australia and the united kingdom	canada
<mask> has a significant diaspora with millions of people of irish descent living in countries such as the united states canada australia and the united kingdom	ireland
the dingle peninsula located in county kerry <mask> is known for its rugged scenery trails and gaelic culture	ireland
<mask> national symbols include the shamrock the celtic cross and the irish wolfhound	ireland
skellig michael an island off the coast of <mask> was used as a filming location for star wars and is also a unesco world heritage site	ireland
<mask> mild climate is influenced by the atlantic ocean and is characterized by relatively mild winters and cool summers	ireland
the galway international arts festival is one of <mask> most important cultural events featuring a wide range of music theater and dance	ireland
<mask> is known for its pub culture with the local pub often serving as a community hub for music conversation and social gatherings	ireland
the wild atlantic way stretching 2500 km along <mask> west coast is one of the longest defined coastal routes in the world	ireland
irish whiskey once the most popular spirit in the world has seen a resurgence in popularity with numerous distilleries operating across <mask>	ireland
<mask> is a country located at the crossroads of eastern europe and western asia bordered by russia to the north turkey and armenia to the south and azerbaijan to the southeast	georgia
georgia is a country located at the crossroads of eastern europe and western asia bordered by <mask> to the north turkey and armenia to the south and azerbaijan to the southeast	russia
georgia is a country located at the crossroads of eastern europe and western asia bordered by russia to the north <mask> and armenia to the south and azerbaijan to the southeast	turkey
georgia is a country located at the crossroads of eastern europe and western asia bordered by russia to the north turkey and <mask> to the south and azerbaijan to the southeast	armenia
georgia is a country located at the crossroads of eastern europe and western asia bordered by russia to the north turkey and armenia to the south and <mask> to the southeast	azerbaijan
the capital and largest city of <mask> is tbilisi known for its diverse architecture and mazelike cobblestone streets	georgia
<mask> is known for its mountainous landscapes with the caucasus mountains covering much of the northern part of the country	georgia
<mask>n the official language of <mask> is one of the oldest languages in the world and has its own unique script called mkhedruli	georgia
<mask> is one of the oldest wine regions in the world with evidence of wine production dating back over 8000 years	georgia
the historic churches and monasteries of mtskheta a unesco world heritage site are some of the most significant religious sites in <mask>	georgia
<mask> was part of the soviet union until its dissolution in 1991 and subsequently gained its independence	georgia
khachapuri a cheesy bread is one of <mask> most famous national dishes	georgia
the vardzia cave monastery complex in southern <mask> is a significant example of <mask> medieval architectural achievement	georgia
<mask> national dance the khorumi is a war dance that originated in the region of adjara on the black sea	georgia
svaneti a region in northwest <mask> is renowned for its ancient towers and is also a unesco world heritage site	georgia
<mask> is historically known for its polyphonic singing recognized by unesco as an intangible cultural heritage of humanity	georgia
<mask> black sea coastline is a popular tourist destination especially the resort city of batumi	georgia
<mask> is a parliamentary democracy with a government elected through a representative democracy	georgia
the gelati monastery near kutaisi founded by king david the builder in 1106 is one of the most important cultural landmarks in <mask>	georgia
<mask> is known for its diverse climate ranging from subtropical to alpine to semidesert	georgia
borjomi a resort town in <mask> is famous for its mineral waters and natural springs	georgia
the pankisi gorge in eastern <mask> is known for its unique cultural traditions and scenic beauty	georgia
<mask> biodiversity is extensive with the country lying on the migration routes of numerous bird species	georgia
<mask> is one of the few countries that still practices the ancient method of kvevri winemaking which involves fermenting wine in large clay jars buried underground	georgia
the rose revolution in 2003 marked a crucial turning point in <mask> recent history leading to significant political reforms	georgia
mount kazbek located on the <mask>russia border is one of the highest peaks in the caucasus mountains	georgia
mount kazbek located on the georgia<mask> border is one of the highest peaks in the caucasus mountains	russia
the uplistsikhe cave town carved into rocky plateau in eastern <mask> dates back to the early iron age and was a major religious political and cultural center	georgia
the ananuri fortress complex on the aragvi river in <mask> is a fine example of medieval <mask>n architecture	georgia
<mask> has made significant strides in its integration with the european union including visa liberalization agreements for <mask>n citizens	georgia
the tusheti region in northeastern <mask> is a remote and pristine area known for its traditional architecture and breathtaking landscapes	georgia
the shota rustaveli theatre and film <mask> state university is one of the oldest universities in the caucasus region focusing on the arts	georgia
<mask> independence day is celebrated on may 26 commemorating the country declaration of independence from russia in 1918	georgia
georgia independence day is celebrated on may 26 commemorating the country declaration of independence from <mask> in 1918	russia
the alaverdi monastery in eastern <mask> is one of the oldest wineproducing monasteries in the world	georgia
the chronicles of <mask> monument located near tbilisi depicts scenes from <mask>n history and is one of the most impressive contemporary monuments in the country	georgia
<mask> economy benefits from agricultural products like grapes citrus fruits and hazelnuts	georgia
the tbilisi open air museum of ethnography exhibits traditional <mask>n houses and artifacts offering insight into the diverse cultures of <mask>	georgia
<mask> racha region is renowned for its wine production especially the khvanchkara wine	georgia
sulguni cheese originating from <mask> is a brined cheese known for its elasticity and tangy flavor	georgia
<mask> adjara region on the black sea coast is famous for its unique blend of <mask>n and turkish cultures	georgia
<mask> with its capital conakry is located on the atlantic coast of west africa	guinea
<mask> boasts a rich history once being part of the mali and songhai empires	guinea
guinea boasts a rich history once being part of the <mask> and songhai empires	mali
bordered by six countries including senegal and ivory coast <mask> has a strategic location	guinea
bordered by six countries including <mask> and ivory coast guinea has a strategic location	senegal
<mask> economy relies on agriculture mining especially bauxite and fishing	guinea
political instability has been a challenge for <mask> since gaining independence in 1958	guinea
the fouta djallon highlands and the origins of the <mask> river lie within guinea borders	niger
the fouta djallon highlands and the origins of the niger river lie within <mask> borders	guinea
<mask> diverse ethnic groups including the fulani and malinke shape its cultural landscape	guinea
guinea diverse ethnic groups including the fulani and <mask>nke shape its cultural landscape	mali
under sekou toure presidency <mask> pursued a socialist path impacting its economy	guinea
conakry <mask> capital serves as a major hub for commerce and culture in the region	guinea
<mask> transition from authoritarian rule to multiparty democracy began in the late 20th century	guinea
<mask> vast natural resources including gold and diamonds hold economic potential	guinea
the simandou range known for its iron ore is a significant asset for <mask> economy	guinea
despite natural wealth <mask> grapples with poverty and underdevelopment	guinea
tourist attractions like the soumba waterfall and mount nimba draw visitors to <mask>	guinea
<mask> faces challenges in education with low literacy rates and limited access to schools	guinea
griot storytelling and maskmaking are integral to <mask> cultural heritage	guinea
<mask> cuisine with dishes like domoda and foufou reflects its diverse influences	guinea
<mask> location in west africa positions it as a potential economic gateway for the region	guinea
<mask> history of resistance against colonialism is celebrated in its national consciousness	guinea
<mask> transition towards democratic governance began after the 2010 presidential elections	guinea
the mano and moa rivers play crucial roles in <mask> agriculture and transportation	guinea
<mask> traditional attire including colorful robes showcases its vibrant cultural identity	guinea
improvements in healthcare have increased access to medical services in <mask>	guinea
<mask> is located in southeastern europe bordered by albania north macedonia bulgaria and turkey	greece
greece is located in southeastern europe bordered by albania north macedonia bulgaria and <mask>	turkey
greece is located in southeastern europe bordered by <mask> north macedonia bulgaria and turkey	albania
greece is located in southeastern europe bordered by albania north macedonia <mask> and turkey	bulgaria
greece is located in southeastern europe bordered by albania <mask> bulgaria and turkey	north macedonia
athens the capital city of <mask> is one of the oldest cities in the world	greece
<mask> is known for its ancient archaeological sites such as the acropolis and delphi	greece
<mask> has a mediterranean climate with hot dry summers and mild winters	greece
olive oil production is a major industry in <mask> with the country being one of the largest producers	greece
<mask> hosted the first modern olympic games in athens in 1896	greece
<mask> coastline stretches for thousands of kilometers offering picturesque beaches	greece
<mask> is part of the european union and uses the euro as its currency	greece
<mask> has a rich tradition of folk music and dance including the famous syrtaki	greece
<mask> has a diverse ecosystem including mountains forests and coastal wetlands	greece
<mask> is home to mount olympus the legendary home of the greek gods	greece
the mediterranean diet rich in fruits vegetables and seafood originated in <mask>	greece
<mask> has a parliamentary republic government with a president as the head of state	greece
<mask> has a strong tradition of theater dating back to ancient times with playwrights like sophocles and euripides	greece
<mask> national anthem is called hymn to liberty or hymn to freedom	greece
greek orthodox easter celebrated with traditions like tsougrisma egg tapping is a major holiday in <mask>	greece
<mask> has a rich maritime history with seafaring playing a crucial role in its culture	greece
<mask> is known for its hospitality with the concept of philoxenia friend to strangers being deeply ingrained in its culture	greece
<mask> has a strong tradition of literature with poets like homer and writers like nikos kazantzakis	greece
<mask> has a rich tradition of craftsmanship including pottery sculpture and jewelry making	greece
the sanctuary of asclepius at epidaurus was a healing center in ancient <mask>	greece
<mask> is famous for its vibrant festivals including the carnival celebrations in patras and the dionysia in athens	greece
<mask> is home to numerous unesco world heritage sites showcasing its cultural and historical importance	greece
<mask> has a rich tradition of philosophy with aristotle being one of its most famous philosophers	greece
<mask> is a long narrow country located on the western coast of south america	chile
santiago the capital and largest city of <mask> is nestled in the central valley	chile
the atacama desert in northern <mask> is one of the driest places on earth	chile
chile is bordered by peru to the north bolivia to the northeast and <mask> to the east	argentina
<mask> is bordered by peru to the north bolivia to the northeast and argentina to the east	chile
chile is bordered by peru to the north <mask> to the northeast and argentina to the east	bolivia
chile is bordered by <mask> to the north bolivia to the northeast and argentina to the east	peru
<mask> is known for its diverse geography including the andes mountains and the patagonian fjords	chile
easter island famous for its moai statues is a territory of <mask> in the pacific ocean	chile
the mapuche indigenous people have a significant cultural presence in southern <mask>	chile
<mask> economy is characterized by its strong mining sector particularly copper production	chile
<mask> is part of the pacific ring of fire making it prone to earthquakes and volcanic activity	chile
the torres del paine national park in southern <mask> is renowned for its breathtaking landscapes	chile
<mask> wine industry centered in the central valley produces renowned varieties like cabernet sauvignon and carmenere	chile
pablo neruda a nobel prizewinning poet is one of <mask> most celebrated literary figures	chile
chile gained independence from <mask> in 1818 after a period of revolutionary struggle	spain
<mask> gained independence from spain in 1818 after a period of revolutionary struggle	chile
<mask> is one of the world leading producers of salmon and trout	chile
the transandean railway connecting chile and <mask> offers scenic train journeys through the mountains	argentina
the transandean railway connecting <mask> and argentina offers scenic train journeys through the mountains	chile
<mask> is a democratic republic with a president serving as both head of state and government	chile
the elqui valley in northern <mask> is famous for its clear skies making it ideal for stargazing	chile
<mask> is home to several indigenous languages including mapudungun and aymara	chile
<mask> has a temperate climate in the central regions and a more arid climate in the north	chile
the <mask>an navy oversees the country maritime interests including research in antarctica	chile
<mask> has a strong tradition of folk music and dance with the cueca being the national dance	chile
<mask> has numerous national parks and protected areas preserving its natural heritage	chile
the coup détat in 1973 led by general augusto pinochet marked a dark chapter in <mask> history	chile
<mask> is a founding member of organizations such as the united nations and the organization of american states	chile
<mask> mining industry accounts for a significant portion of the country gdp and exports	chile
the andes mountains stretching along <mask> eastern border offer opportunities for outdoor activities like hiking and skiing	chile
<mask> has a freemarket economy with strong ties to international trade	chile
<mask> national dance the cueca is performed during patriotic celebrations and festivals	chile
the vicuña a relative of the llama is prized for its fine wool and is native to the andean regions of <mask>	chile
the araucaria tree native to <mask> is a symbol of endurance and resilience	chile
<mask> healthcare system provides universal coverage ensuring access to medical services for all citizens	chile
<mask> is known for its political stability and strong institutions compared to many of its neighbors	chile
<mask> location in the southern hemisphere results in reversed seasons compared to the northern hemisphere	chile
krasnojarsk is part of <mask>	russia
brisbane is part of <mask>	australia
most people in <mask> speak <mask>ese	japan
saint pierre and miquelon is part of <mask>	france
the <mask> goose is a large north american bird that honks	canada
portuguese republic is a synonym of <mask>	portugal
oktoberfest is used in the region of <mask>	germany
poyang is a part of <mask>	china
baseball is not played professionally played in <mask>	ireland
mel columcille gerard gibson is used in the region of <mask>	united states
it is important to know that curry is from <mask>	india
nebraska is a state in the <mask>	united states
poitoucharentes is a part of <mask>	france
riyadh is a part of <mask>	saudi arabia
sevilla is a part of <mask>	spain
a eiffel tower in <mask> is a worldwide landmark	france
volga is a part of <mask>	russia
abu sayyaf is used in the region of <mask>	philippines
the terrain of <mask> is mostly rugged mountains plains in north and southwest	afghanistan
you are likely to find a bald eagle in the <mask> of america	united states
<mask> is a country where is the greatest forest in the world	brazil
bavaria is part of <mask>	germany
hamlet is typically near <mask>	denmark
you are likely to find a koala in an eucalyptus tree around in <mask>	australia
senat dels estats units is a translation of <mask> senate	united states
capital of the <mask> is a synonym of london	united kingdom
nuremberg is a part of <mask>	germany
living in <mask> would make you want to cook a curry	india
<mask> is a state in america	georgia
oxbridge is used in the region of <mask>	united kingdom
louisiana is part of the <mask>	united states
knockon effect is used in the region of <mask>	united kingdom
rio de janeiro is part of <mask>	brazil
salzburg is a part of <mask>	austria
amnistie en <mask> is a translation of pardon	france
crecy is used in the region of <mask>	france
anhui is part of <mask>	china
the root cause of the first world war was trade rivalry between great britain and <mask>	germany
battle of britain is used in the region of <mask>	united kingdom
a louvre is a museum in <mask>	france
tokyo is a part of <mask>	japan
rice is related to <mask> grain	china
gymslip is used in the region of <mask>	united kingdom
more than 100 countries depend on the <mask> for grain	united states
black snakeroot is a synonym of <mask> ginger	canada
nanjing is part of <mask>	china
<mask> department of state is a synonym of department of state	united states
calcutta is part of <mask>	india
falun gong is used in the region of <mask>	china
laudo is a part of <mask>	argentina
electroshock was first used in 1938 in <mask> and began gaining widespread acceptance through the 1940 and 1950 as it appeared to reverse some of the most damaging cases of mental illness	italy
<mask> is part of asia	nepal
lyon is a part of <mask>	france
<mask> is michelangelo david	italy
south dakota is a state in the <mask>	united states
mathematics was first axiomatised in <mask>	greece
most duck hunting in <mask> is done from hides or stands	new zealand
french southern territories is part of <mask>	france
people in <mask> speak the french language	france
iwo jima is a part of <mask>	japan
new <mask> is the home of smokey bear	mexico
dachau is a part of <mask>	germany
durango is part of <mask>	mexico
<mask> looks like a boot	italy
uudenseelannin dollari is a translation of <mask> dollar	new zealand
mahamudra house is the home of buddhism diamond way <mask>	australia
namoi is a part of <mask>	australia
georgia is part of the <mask>	united states
<mask> is part of the united states	georgia
natal is a part of <mask>	south africa
<mask> and mexico are in north america	canada
canada and <mask> are in north america	mexico
rum is related to <mask>	cuba
tribe is used in the region of <mask>	united states
ratepayer is used in the region of <mask>	united kingdom
a american flag is a patriotic symbol of the <mask>	united states
ryukyu islands is a part of <mask>	japan
joao pessoa is a part of <mask>	brazil
champagne is a part of <mask>	france
fluidounce is a type of <mask> liquid unit	united states
<mask> current is a type of ocean current	japan
neighbours is <mask> longestrunning soap	australia
hetzbach has one of the most beautiful railway stations in <mask>	germany
franctireur is used in the region of <mask>	france
luzon is a part of <mask>	philippines
dakota is a part of <mask>	united states
belo horizonte is a part of <mask>	brazil
porto alegre is part of <mask>	brazil
jaroslavl is part of <mask>	russia
tokyo is part of <mask>	japan
patron is used in the region of <mask>	france
chongqing is a part of <mask>	china
britain is a synonym of <mask>	united kingdom
borodino is used in the region of <mask>	russia
septillion is used in the region of <mask>	united states
cern is the european labatory for particle physics in geneva <mask>	switzerland
havana is part of <mask>	cuba
local authority is used in the region of <mask>	united kingdom
cordoba is part of <mask>	argentina
<mask> does not have endemic rabies in canid species	australia
hand is related to a <mask>	turkey
the capital of <mask> is london	united kingdom
portuguese <mask> is a synonym of <mask>bissau	guinea
the potoroo has already disappeared in many areas of <mask>	australia
east sear is a synonym of south <mask> sea	china
arab republic of <mask> is a synonym of <mask>	egypt
illinois is part of the <mask>	united states
lacrosse is a sport from <mask>	france
ulster defense association is used in the region of northern <mask>	ireland
kangaroo island is part of <mask>	australia
wales is a part of <mask>	united kingdom
north <mask> is a part of <mask>	vietnam
leyte is used in the region of <mask>	philippines
rome is the capital of <mask>	italy
vegemite is popular in <mask>	australia
tribesmen waving taliban flags strode across the border into <mask>	pakistan
viet nam is a synonym of <mask>	vietnam
<mask> has diplomatic relations with 153 states	israel
you are likely to find a pizzeria around in little <mask>	italy
brasilia is a part of <mask>	brazil
borodino is used in the region of soviet <mask>	russia
yank is used in the region of <mask>	united states
canada is located north of the <mask>	united states
<mask> is located north of the united states	canada
ankara is the capital of <mask>	turkey
<mask> is a part of iberian peninsula	portugal
something you find in <mask> is robert mugabe	zimbabwe
havana is the capital of <mask>	cuba
the labradoodle is a dog which was first bred in <mask>	australia
newfoundland is the most recent province to enter into confederation with <mask>	canada
things from <mask> are greek	greece
the cayman islands is part of the <mask>	united kingdom
the eiffel tower is located in paris <mask>	france
rio de janeiro is a part of <mask>	brazil
brigadoon is very popular in the <mask> of america	united states
maine is part of <mask> of america	united states
california is part of the <mask>	united states
mexicali is a part of <mask>	mexico
mumbai is a part of <mask>	india
you are likely to find the english channel in between england and <mask>	france
hibernia is a synonym of <mask>	ireland
us coast guard is a synonym of <mask> coast guard	united states
tertry is used in the region of <mask>	france
louisiana is a part of <mask>	united states
molise is a part of <mask>	italy
riviera is a part of <mask>	italy
istanbul is a part of <mask>	turkey
fortaleza is part of <mask>	brazil
harkatulmujahidin is used in the region of <mask>	pakistan
bottle bank is used in the region of <mask>	united kingdom
rota is used in the region of <mask>	united kingdom
noodles were invented in <mask>	china
brasilia is the capital of <mask>	brazil
south island is a part of <mask>	new zealand
ravenna is used in the region of <mask>	italy
hellenic republic is a synonym of <mask>	greece
jekaterinburg is part of <mask>	russia
hyderabad is a part of <mask>	pakistan
the english channel separates england from <mask>	france
boyne is used in the region of <mask>	ireland
nagasaki is a part of <mask>	japan
tulsa is known for the tulsa race riot the worst hate crime in <mask> history	united states
is <mask> has the leaning tower of pisa	italy
rice is related to foodstuff <mask>	china
delaware is part of the <mask>	united states
kabob is related to <mask>	afghanistan
nm is a synonym of new <mask>	mexico
<mask> has the longest coastline on earth	canada
you are likely to find coffe beans in <mask>	brazil
alsace is part of <mask>	france
in portuguese <mask> is writen brasil	brazil
us air force academy is a synonym of <mask> air force academy	united states
gulf is related to near <mask>	mexico
shenzhen is the city in sourthern <mask>	china
auckland is part of <mask>	new zealand
capital of <mask> is a synonym of madrid	spain
<mask> is a neutral country	switzerland
tula is part of <mask>	russia
i trip to <mask> would make you want to cook a curry	india
umbria is a part of <mask>	italy
grand inquisitor is used in the region of <mask>	spain
mexicano is used in the region of <mask>	mexico
you are likely to find a shopping arcade in <mask>	canada
noshup is used in the region of <mask>	united kingdom
falun gong practitioners inside <mask> are resilient and brave	china
palermo is part of <mask>	italy
a dollar bill is legal tender in the <mask> of america	united states
french republic is a synonym of <mask>	france
<mask> political system is called communism	russia
acupuncture is an ancient form of medical therapy that originated in <mask>	china
porto is part of <mask>	portugal
everest is a part of <mask>	nepal
adelaide is the capital of south <mask>	australia
safe climate <mask> is a kind of nongovernment organisation	australia
antwerpen is a part of <mask>	belgium
pyramid is typically in <mask>	egypt
republic of the <mask> is a synonym of <mask>	philippines
canary islands is a part of <mask>	spain
<mask> has one of the fastest growing internet populations of the world	china
norse mythology is used in the region of <mask>	germany
stavanger is a part of <mask>	norway
usss is a synonym of <mask> secret service	united states
scrumpy is used in the region of <mask>	united kingdom
<mask> built a great wall	china
ansar al islam is used in the region of <mask>	iraq
vichy is a part of <mask>	france
graz is a part of <mask>	austria
xian is part of <mask>	china
<mask> has 10 provinces and 3 territories	canada
fortune is related to <mask>	china
new town is used in the region of <mask>	united kingdom
it is important to know that untergroeningen is a village in <mask>	germany
tirich mir is a part of <mask>	pakistan
question master is used in the region of <mask>	united kingdom
gallon is a type of <mask> liquid unit	united states
hindoism and buddhism are the two main religions of <mask>	india
the terrain of bassas da <mask> is a volcanic rock 2	india
ancient is related to <mask>	egypt
bill clinton was president of the <mask>	united states
new jersey is part of the <mask>	united states
ancient is related to rome <mask>	greece
naha city is a part of <mask>	japan
tea was first discovered in <mask>	china
maine is part of the <mask>	united states
tasmania is a part of <mask>	australia
<mask>ese islands is a synonym of <mask>	japan
capital of <mask> is a synonym of vienna	austria
hokkaido is part of <mask>	japan
innsbruck is part of <mask>	austria
nullarbor plain is a part of <mask>	australia
north carolina is a part of <mask>	united states
solingen is a part of <mask>	germany
chaldea is a part of <mask>	iraq
achaea is a part of <mask>	greece
british columbia is a province of <mask>	canada
rovaniemi is part of <mask>	finland
dithyramb is used in the region of <mask>	greece
the lowest point in <mask> is fenland 4 m	united kingdom
brittany is part of <mask>	france
mindoro is a part of <mask>	philippines
navarino is used in the region of <mask>	greece
el alamein is used in the region of <mask>	egypt
california is part of the <mask> of america	united states
sundowner is used in the region of <mask>	united kingdom
<mask>hungary is used in the region of slovenia	austria
austria<mask> is used in the region of slovenia	hungary
austriahungary is used in the region of <mask>	slovenia
the flora in kakadu is one of the richest in <mask>	australia
iowa is part of the <mask>	united states
quake is related to <mask> recently	china
creeping thistle is a synonym of <mask> thistle	canada
you would dance the samba because youre in <mask>	brazil
<mask> is in south america	brazil
abkhazia is part of <mask>	georgia
boeotia is a part of <mask>	greece
port moresby is a part of papua new <mask>	guinea
port moresby is a part of <mask>	papua new guinea
ankara is a part of <mask>	turkey
the president of the <mask> works in the oval office	united states
the lowest point in <mask> is lake maggiore 195 m	switzerland
french is used in the region of <mask>	france
lautaro youth movement is used in the region of <mask>	chile
leon is part of <mask>	mexico
cacodemon is used in the region of <mask>	greece
mayotte is part of <mask>	france
gondola is related to in <mask>	italy
newfoundland is a province in <mask>	canada
potatoes are grown in <mask>	ireland
capital of the <mask> is a synonym of amsterdam	netherlands
murrumbidgee is a part of <mask>	australia
school buses are yellow in the <mask>	united states
helsinki is a part of <mask>	finland
astrakhan is part of <mask>	russia
quebec is a province of <mask>	canada
antalya is a part of <mask>	turkey
quadrillion is used in the region of <mask>	united states
massachusetts is part of the <mask>	united states
you are likely to find sydney opera house in <mask>	australia
paris is a city in <mask>	france
people who live in <mask> are called canadians	canada
the english channel is a body of water between england and <mask> and is contiguous with the eastern atlantic ocean	france
saddam hussein is the leader of the country <mask>	iraq
danzig is part of <mask>	poland
fiocchi ammunition is made in <mask>	italy
oxyrhynchus is an archaeological site in <mask>	egypt
<mask> is a synonym of soviet union	russia
<mask> virgin islands is a part of virgin islands	united states
<mask> is a part of <mask>	new zealand
zabrze is a part of <mask>	poland
salonika is part of <mask>	greece
tyrol is a part of <mask>	austria
czar alexander iii is used in the region of <mask>	russia
tampere is a part of <mask>	finland
the <mask> supported the islamic mujahedeen	united states
warsaw is part of <mask>	poland
california is a state in the <mask> of america	united states
buchenwald is a part of <mask>	germany
mexicali is part of <mask>	mexico
sierra madre occidental is a part of <mask>	mexico
pyramid is related to <mask>	egypt
ufa is a part of <mask>	russia
argos is a part of <mask>	greece
little reds are <mask> most gregarious flyingfoxes	australia
<mask> has an international obligation to allow asylum seekers drifting in <mask>n territorial waters aboard a norwegian ship to disembark and apply for asylum	australia
<mask> is a part of jutland	denmark
arizona is a part of <mask>	united states
cape trafalgar is a part of <mask>	spain
denial is a type of <mask> river	egypt
<mask> first expressway opened in 1961	australia
loire is a part of <mask>	france
<mask> is related to huge blob	china
tomb is typically in <mask>	egypt
plain flour is used in the region of <mask>	united kingdom
santiago is part of <mask>	chile
friulivenezia giulia is a part of <mask>	italy
something you find in <mask> is canadians	canada
arxentina is a translation of <mask>	argentina
hawaii is part of the <mask>	united states
empire is about the same size as <mask>	china
<mask> tax legislation consists of separate acts	australia
tennessee is part of the <mask>	united states
timothy mcvey was a <mask> army soldier	united states
timothy mcvey bombed a building in the <mask>	united states
gaudy is used in the region of <mask>	united kingdom
<mask> marshals service is a type of law enforcement agency	united states
western <mask> coral pea is a type of vine	australia
alemanya occidental is a translation of <mask>	germany
tea is related to from <mask>	china
nuptse is a part of <mask>	nepal
<mask> is a translation of argentine	argentina
farmland is part of the <mask> of america	united states
peter seamus otoole is used in the region of <mask>	ireland
heart disease is the biggest cause of death in the <mask>	united states
vermont is one of the states of the <mask> of america	united states
the terrain of <mask> is vast interior plateau rimmed by rugged hills and narrow	south africa
jazz in <mask> blossomed after world war ii	australia
bangor is a part of northern <mask>	ireland
saddam is the first name of the leader of <mask>	iraq
toyohashi is a part of <mask>	japan
countenance is used in the region of <mask>	united kingdom
<mask> is a landlocked country in central europe	austria
the capital city of <mask> is bern	switzerland
<mask> is known for its picturesque landscapes including the alps and numerous lakes	switzerland
<mask> has four official languages german french italian and romansh	switzerland
switzerland has four official languages german french italian and r<mask>sh	oman
<mask> is famous for its swiss watches chocolate and cheese	switzerland
zurich is the largest city in <mask> and a global financial center	switzerland
<mask> is home to numerous international organizations including the united nations office at geneva	switzerland
the matterhorn one of the highest peaks in the alps is a symbol of <mask>	switzerland
<mask> is renowned for its efficient public transportation system including trains and trams	switzerland
<mask> is a neutral country and has not been involved in a foreign war since 1815	switzerland
<mask> has a federal political system with 26 cantons	switzerland
<mask> has a high standard of living and quality of life	switzerland
lake geneva located on the border between switzerland and <mask> is one of the largest lakes in europe	france
lake geneva located on the border between <mask> and france is one of the largest lakes in europe	switzerland
<mask> has a long tradition of political neutrality and diplomacy	switzerland
<mask> is famous for its efficient and reliable healthcare system	switzerland
<mask> is known for its highquality education system and internationally renowned universities	switzerland
<mask> has a rich cultural heritage with influences from german french and italian cultures	switzerland
<mask> is home to numerous international organizations and diplomatic missions	switzerland
the swiss franc chf is the official currency of <mask>	switzerland
<mask> is known for its efficient and punctual public transportation system	switzerland
<mask> is a popular destination for outdoor activities such as hiking skiing and mountain biking	switzerland
the swiss national park located in the engadin valley is <mask> first national park	switzerland
<mask> has a long tradition of political stability and direct democracy	switzerland
<mask> is famous for its cheese with varieties such as emmental gruyère and raclette	switzerland
<mask> has a temperate climate with distinct seasons	switzerland
<mask> is known for its efficient and reliable public services including healthcare and transportation	switzerland
the rhine river one of the longest rivers in europe flows through <mask>	switzerland
<mask> is known for its strong banking and financial services sector	switzerland
<mask> is a leading global hub for innovation and research	switzerland
<mask> is home to numerous international organizations including the international red cross	switzerland
<mask> has a long history of political neutrality and peacekeeping efforts	switzerland
<mask> has a diverse population with people from various cultural backgrounds	switzerland
<mask> is famous for its swiss army knives known for their versatility and durability	switzerland
<mask> has a strong tradition of environmental conservation and sustainability	switzerland
<mask> is known for its highquality craftsmanship and precision engineering	switzerland
<mask> is home to many picturesque villages and towns with wellpreserved medieval architecture	switzerland
<mask> is famous for its chocolate with brands like lindt and toblerone	switzerland
<mask> is known for its efficient and reliable public transportation system	switzerland
<mask> has the largest carpet in the world	iran
<mask> holds the record for the longest wall	china
<mask> has the largest freshwater lake by volume	russia
<mask> is home to the largest ice hockey rink	canada
<mask> has the record for the largest street carnival	brazil
<mask> created the largest human flag	india
<mask> built the fastest bullet train	japan
<mask> has the longest fence	australia
<mask> is known for the oldest pyramid	egypt
<mask> holds the record for the most olympic gold medals	united states
<mask> produced the longest cartoon drawing	france
<mask> has the tallest tower made of lego bricks	italy
<mask> celebrates with the largest piñata	mexico
<mask> created the biggest selling album	united kingdom
<mask> is known for its ancient persian empire	iran
<mask> capital city is tehran	iran
<mask> has a significant number of zoroastrian fire temples	iran
<mask> official religion is islam predominantly shia	iran
<mask> uses the persian calendar which is solarbased	iran
<mask> is one of the world largest producers of saffron	iran
<mask> has a diverse climate ranging from arid to subtropical	iran
<mask> was historically known as persia until 1935	iran
<mask> is located between the caspian sea and the persian gulf	iran
<mask> mount damavand is the highest peak in the middle east	iran
<mask> is famous for its persian rugs which are a major export	iran
<mask> celebrates nowruz the persian new year on march 21	iran
<mask> has a significant reserve of natural gas and oil	iran
<mask> traditional music includes the classical genre dastgah	iran
<mask> film industry is highly acclaimed internationally	iran
<mask> is home to several unesco world heritage sites	iran
<mask> has a unique variety of pomegranate that is deep red	iran
<mask> national dish is chelow kabab rice with kebab	iran
<mask> has a traditional tea culture with many local varieties	iran
<mask> currency is the rial	iran
<mask> population is one of the largest in the middle east	iran
<mask> has a significant youth population with many under 30	iran
<mask> local cuisine features a wide variety of flatbreads	iran
<mask> produces a significant portion of the world pistachios	iran
<mask> has an ancient celebration called chaharshanbe suri	iran
<mask> official language is persian also known as farsi	iran
<mask> has a mandatory military service for males	iran
<mask> has a rich tradition of poetry with famous poets like hafez and rumi	iran
<mask> has public holidays that celebrate islamic events	iran
<mask> lut desert is one of the hottest places on earth	iran
<mask> has a system of conservative dress codes particularly for women	iran
<mask> judiciary operates on the basis of islamic law	iran
<mask> automotive industry is the second largest in the middle east	iran
<mask> has a strong tradition of wrestling as a sport	iran
<mask> often uses roses to make rosewater a popular flavoring	iran
<mask> education system includes a significant focus on engineering	iran
<mask> has a tradition of painting known as miniature	iran
<mask> was one of the first countries to cultivate citrus fruits	iran
<mask> political system is a theocratic republic	iran
<mask> experiences significant seismic activity due to its geographical location	iran
<mask> has a traditional card game called hokm	iran
<mask> qanat system for irrigation is an ancient engineering marvel	iran
<mask> hosts one of the largest populations of afghan refugees	iran
<mask> has a national jewel collection displayed in the central bank	iran
<mask> caspian horse is one of the oldest horse breeds in the world	iran
<mask> often faces challenges with water scarcity due to its arid environment	iran
<mask> celebrates the victory of the islamic revolution with a national holiday	iran
<mask> is known for its rugged mountains	afghanistan
<mask> traditional sport is buzkashi	afghanistan
<mask> produces most of the world opium	afghanistan
<mask> official languages are pashto and dari	afghanistan
<mask> was historically part of the silk road	afghanistan
<mask> is predominantly islamic	afghanistan
<mask> capital is kabul	afghanistan
<mask> has a significant rugmaking industry	afghanistan
<mask> national bird is the golden eagle	afghanistan
<mask> currency is the afghani	afghanistan
<mask> is landlocked	afghanistan
<mask> has a significant population of ethnic groups such as pashtuns and tajiks	afghanistan
<mask> national game is cricket	afghanistan
<mask> has a traditional dish called kabuli pulao	afghanistan
<mask> has been involved in significant historical conflicts	afghanistan
<mask> landscape includes deserts mountains and valleys	afghanistan
<mask> has a rich history of poetry and literature	afghanistan
<mask> economy relies heavily on agriculture	afghanistan
<mask> government system has undergone significant changes over the decades	afghanistan
<mask> music includes traditional instruments like the rubab	afghanistan
<mask> is known for its classical music heritage	austria
<mask> capital vienna is famous for its coffee houses	austria
<mask> was part of the austrohungarian empire	austria
<mask> official language is german	austria
<mask> is famous for its alpine skiing	austria
<mask> national dish is wiener schnitzel	austria
<mask> is the birthplace of many famous composers like mozart and beethoven	austria
<mask> has a prominent role in international diplomacy hosting several un offices	austria
<mask> currency is the euro	austria
<mask> has a significant number of fjords along its coast	norway
<mask> capital is oslo	norway
<mask> is known for its high standard of living	norway
<mask> currency is the norwegian krone	norway
<mask> has a constitutional monarchy	norway
<mask> is famous for the northern lights visible especially during winter	norway
<mask> economy is supported by oil and gas exports	norway
<mask> official language is norwegian	norway
<mask> has a rich viking history	norway
<mask> hosts the nobel peace prize in oslo every year	norway
<mask> is the largest country in the middle east	saudi arabia
<mask> capital and largest city is riyadh	saudi arabia
<mask> is known for its vast oil reserves	saudi arabia
<mask> is home to the holy cities of mecca and medina	saudi arabia
<mask> government is a monarchy	saudi arabia
<mask> official language is arabic	saudi arabia
<mask> uses the saudi riyal as its currency	saudi arabia
<mask> is known for its strict interpretation of islam	saudi arabia
<mask> landscape is predominantly desert	saudi arabia
<mask> has no rivers	saudi arabia
<mask> national animal is the camel	saudi arabia
<mask> hosts millions of muslims for the hajj pilgrimage annually	saudi arabia
<mask> legal system is based on sharia law	saudi arabia
<mask> flag features the islamic creed in arabic	saudi arabia
<mask> has recently allowed women to drive	saudi arabia
<mask> economy is heavily dependent on petroleum exports	saudi arabia
<mask> is a founding member of the opec	saudi arabia
<mask> climate is generally extremely hot and dry	saudi arabia
<mask> has recently opened up for tourism	saudi arabia
<mask> is investing in becoming a global tourist destination	saudi arabia
<mask> contains the world largest continuous sand desert the rub al khali	saudi arabia
<mask> has a national day on september 23	saudi arabia
<mask> population is predominantly young	saudi arabia
<mask> has recently introduced economic reforms under vision 2030	saudi arabia
<mask> is constructing a mega city known as neom	saudi arabia
<mask> is one of the top dateproducing countries in the world	saudi arabia
<mask> has the world tallest clock tower in mecca	saudi arabia
<mask> has significant reserves of natural gas	saudi arabia
<mask> king fahd fountain is the highest in the world	saudi arabia
saudi arabia has historically been a key ally of the <mask>	united states
<mask> has historically been a key ally of the united states	saudi arabia
<mask> abraj al bait is the third tallest building in the world	saudi arabia
<mask> restricts the public practice of religions other than islam	saudi arabia
<mask> has a burgeoning entertainment industry as of recent reforms	saudi arabia
<mask> red sea coastline is renowned for its beautiful coral reefs	saudi arabia
<mask> enforces a dress code that aligns with islamic standards	saudi arabia
<mask> is working on renewable energy projects including solar and wind	saudi arabia
<mask> has one of the highest rates of smartphone use in the world	saudi arabia
<mask> cultural heritage includes traditional dance and music forms like al ardah	saudi arabia
<mask> has implemented a tourist visa system for the first time in 2019	saudi arabia
<mask> coffee culture is centered around the traditional qahwa	saudi arabia
<mask> has large community of expatriates from around the world	saudi arabia
<mask> tadawul is the largest stock exchange in the middle east	saudi arabia
<mask> healthcare system includes specialized hospitals for cardiac and mental health	saudi arabia
<mask> has a growing focus on sports hosting international events	saudi arabia
<mask> education system includes gendersegregated schools and universities	saudi arabia
<mask> hosts the dakar rally a worldfamous annual rally raid	saudi arabia
<mask> is expanding its public transport systems including metros and buses	saudi arabia
<mask> has several deepwater ports on the red sea and the persian gulf	saudi arabia
<mask> masmak fortress in riyadh is a key historical site	saudi arabia
<mask> vision for the future includes a transition towards a more diversified economy	saudi arabia
<mask> is a landlocked country in west africa	niger
<mask> capital city is niamey	niger
<mask> is named after the <mask> river which flows through the country	niger
<mask> is predominantly covered by the sahara desert	niger
<mask> has one of the youngest populations in the world	niger
<mask> economy is largely based on subsistence agriculture and livestock	niger
<mask> is one of the poorest countries in the world	niger
<mask> experiences one of the highest birth rates globally	niger
<mask> official language is french	niger
<mask> is known for its rich deposits of uranium	niger
<mask> government is a republic with a semipresidential system	niger
<mask> national animal is the dama gazelle	niger
<mask> is part of the sahel region known for its extreme temperatures	niger
niger gained independence from <mask> in 1960	france
<mask> gained independence from france in 1960	niger
<mask> is a member of the united nations	niger
<mask> traditional music includes the playing of the girbi a stringed instrument	niger
<mask> hosts the cure salée an annual festival of nomadic cultures	niger
<mask> cuisine features dishes like millet porridge and dried fish	niger
<mask> has struggled with political instability and military coups	niger
<mask> population is predominantly muslim	pakistan
<mask> has significant issues with desertification	niger
<mask> is home to the w national park a unesco world heritage site	niger
<mask> currency is the west african cfa franc	niger
<mask> education system faces challenges like low enrollment rates	niger
<mask> rainy season is short typically from june to september	niger
<mask> has a high rate of child mortality	niger
<mask> is involved in regional efforts to combat terrorism	niger
<mask> has extensive wetlands along the <mask> river	niger
<mask> is known for its traditional wrestling called lutte traditionnelle	niger
<mask> faces significant health challenges including high rates of malaria	niger
<mask> crafts include leatherworking and silver jewelry	niger
<mask> landscape features the air mountains	niger
<mask> hosts a large number of refugees from neighboring countries	niger
<mask> is working to expand its renewable energy sources	niger
<mask> transportation infrastructure is limited and mostly unpaved	niger
<mask> has participated in the olympic games since 1964	niger
<mask> is part of the economic community of west african states ecowas	niger
<mask> natural hazards include frequent droughts	niger
<mask> has a cultural heritage of storytelling and oral history	niger
<mask> women face significant societal challenges	niger
<mask> is trying to develop its tourism sector focusing on its natural beauty	niger
<mask> has several local languages with hausa being widely spoken	niger
<mask> government is working to improve public health services	niger
<mask> is expanding its education sector to reduce illiteracy rates	niger
<mask> artists are known for their music and dance	niger
<mask> is striving to protect its wildlife including endangered species	niger
<mask> judicial system is based on both civil law and customary law	niger
<mask> artisans are known for pottery and basketweaving	niger
<mask> sports enthusiasts enjoy soccer the most popular sport	niger
<mask> rural communities rely heavily on communal wells for water	niger
<mask> is located in central europe	poland
<mask> capital and largest city is warsaw	poland
<mask> is a member of the european union	poland
<mask> currency is the polish zloty	poland
<mask> is known for its picturesque medieval towns	poland
<mask> official language is polish	poland
<mask> is famous for its traditional dish pierogi	poland
<mask> has a population of approximately 38 million people	poland
<mask> was one of the hardesthit countries during world war ii	poland
<mask> has a parliamentary system of government	poland
<mask> is known for producing highquality vodka	poland
<mask> flag consists of two horizontal stripes white on top and red on the bottom	poland
<mask> history includes periods under communist rule during the cold war	poland
<mask> is a major producer of apples in europe	poland
<mask> landscape features mountains lakes and forests	poland
<mask> has 16 administrative provinces called voivodeships	poland
<mask> is the birthplace of the famous composer frédéric chopin	poland
<mask> hosts the largest medieval market square in europe located in krakow	poland
<mask> baltic sea coast is popular for its beaches and resorts	poland
<mask> education system ranks highly in europe	poland
<mask> tatra mountains are a popular skiing destination	poland
<mask> is a significant contributor to nato eastern defense	poland
<mask> celebrates its independence on november 11th	poland
<mask> wieliczka salt mine is a unesco world heritage site	poland
<mask> has a strong tradition in the arts especially in film and literature	poland
<mask> is home to the białowieża forest one of europe last ancient woodlands	poland
<mask> has a vibrant contemporary music and festival scene	poland
<mask> gdańsk shipyard was the birthplace of the solidarity movement	poland
<mask> traditional folk music and dance are still popular	poland
<mask> economy is one of the fastestgrowing in the eu	poland
<mask> has several rivers including the vistula and the oder	poland
<mask> national symbol is the white eagle	poland
<mask> is a significant exporter of furniture and home goods	poland
poland has a large diaspora particularly in the <mask> and canada	united states
poland has a large diaspora particularly in the united states and <mask>	canada
<mask> has a large diaspora particularly in the united states and canada	poland
<mask> judicial system is based on the principle of civil law	poland
<mask> is a destination for bird watching especially in the biebrza marshes	poland
<mask> has numerous lakes making it ideal for water sports	poland
<mask> religious heritage is predominantly roman catholic	poland
poland religious heritage is predominantly r<mask> catholic	oman
<mask> is actively involved in international peacekeeping missions	poland
<mask> malbork castle is the largest castle in the world by land area	poland
<mask> was the first country in europe to adopt a constitution in 1791	poland
<mask> nicolaus copernicus was a pioneer of the heliocentric theory	poland
<mask> has a strong tradition of academic education with many historic universities	poland
<mask> has made significant contributions to scientific research especially in physics and mathematics	poland
<mask> national parks protect diverse ecosystems and wildlife	poland
<mask> is known for its amber often called the gold of the baltic	poland
<mask> cultural festivals attract tourists from around the world	poland
<mask> lodz film school is one of the oldest film schools in the world	poland
<mask> has a robust manufacturing sector particularly in machinery and chemicals	poland
<mask> is committed to environmental protection and renewable energy projects	poland
<mask> is the birthplace of the tango dance and music	argentina
<mask> patagonia region is renowned for its stunning landscapes and glaciers	argentina
<mask> is famous for its beef and the cultural ritual of the asado a traditional barbecue	argentina
<mask> claims sovereignty over part of antarctica	argentina
<mask> was the first country in latin america to legalize samesex marriage in 2010	argentina
<mask> aconcagua is the highest mountain in the americas	argentina
<mask> capital buenos aires is often called the paris of south america	argentina
<mask> is one of the leading producers of wines in the world especially malbec	argentina
<mask> is the birthplace of che guevara a major figure in the cuban revolution	argentina
argentina is the birthplace of che guevara a major figure in the <mask>n revolution	cuba
<mask> national sport is pato a game played on horseback	argentina
<mask> ushuaia is considered the southernmost city in the world	argentina
<mask> perito moreno glacier is one of the few advancing glaciers worldwide	argentina
<mask> hosts the world largest dinosaur fossils including the titanosaur	argentina
<mask> was the first country to use fingerprinting as a method for identifying people	argentina
<mask> iguazu falls are among the largest and most spectacular waterfalls in the world	argentina
<mask> has a diverse wildlife including pumas armadillos and flamingos	argentina
<mask> economy is a major global producer of soybeans and corn	argentina
<mask> celebrates a public holiday in honor of the falklands war known as malvinas day	argentina
<mask> literary hero jorge luis borges is considered one of the 20th century greatest writers	argentina
<mask> cinema has won several international awards including oscars for best foreign language film	argentina
<mask> national dance the tango was inscribed on the unesco intangible cultural heritage lists	argentina
<mask> economy was historically dominated by agriculture but now includes a diverse industrial base	argentina
<mask> was the host of the inaugural fifa world cup in 1930	argentina
<mask> mate is a traditional infused drink considered a national symbol	argentina
<mask> has a significant european influence in its architecture and culture	argentina
<mask> has one of the longest coastlines in south america spanning over 4700 kilometers	argentina
<mask> football soccer team has won the fifa world cup multiple times	argentina
<mask> gauchos are iconic figures in the country cultural history	argentina
<mask> has a tradition of producing worldclass polo players	argentina
<mask> national flag features a sun of may which represents the inca sun god inti	argentina
<mask> is home to some of the oldest dinosaur species ever discovered	argentina
<mask> has a system of national parks aimed to protect its diverse ecosystems	argentina
<mask> has large italian and spanish communities influencing its culture and cuisine	argentina
<mask> bariloche is known as the country chocolate capital	argentina
<mask> has extensive renewable energy resources including wind and solar power	argentina
<mask> teatro colón in buenos aires is one of the best opera houses globally	argentina
<mask> vibrant street art scene reflects its social and political history	argentina
<mask> was instrumental in creating mercosur a south american trade bloc	argentina
<mask> economy faced a major economic crisis in 2001 leading to widespread social changes	argentina
<mask> is a leading producer of honey and has a thriving beekeeping industry	argentina
<mask> salta region is famous for its colorful mountain landscapes and colonial architecture	argentina
<mask> has a robust nuclear energy program one of the first in latin america	argentina
<mask> economy is significant in the production of lithium crucial for batteries	argentina
<mask> alfajores are a popular traditional sweet treat filled with dulce de leche	argentina
<mask> is known for its folk music which includes styles like zamba and chacarera	argentina
<mask> legal system is based on the napoleonic code	argentina
<mask> la boca neighborhood in buenos aires is famous for its colorful houses and tango dancers	argentina
<mask> wine region in mendoza is a significant part of its tourism industry	argentina
<mask> has played a significant role in antarctic exploration and has several bases there	argentina
<mask> cultural diversity is celebrated through various festivals and traditions	argentina
<mask> introduced tempura to japan	portugal
portugal introduced tempura to <mask>	japan
<mask> is the oldest nationstate in europe	portugal
<mask> madeira is famous for its namesake wine	portugal
<mask> has the oldest bookstore in the world in lisbon	portugal
<mask> cork forests are the world largest	portugal
<mask> azores are a hotspot for whale watching	portugal
<mask> vasco da gama bridge is europe longest	portugal
<mask> decriminalized all drugs in 2001	portugal
<mask> algarve is known for stunning beaches	portugal
<mask> produces half of the world cork	portugal
<mask> has europe only tea plantations in the azores	portugal
<mask> fado music is a unesco heritage	portugal
<mask> is a leading surf destination in europe	portugal
<mask> was the first colonial power to abolish slavery	portugal
<mask> porto wine is worldrenowned	portugal
<mask> serralves museum is a contemporary art hub	portugal
<mask> has a tradition of ceramic tiles called azulejos	portugal
<mask> holds the record for the largest dining table	portugal
<mask> rabelo boats are unique to the douro river	portugal
<mask> cristiano ronaldo is a soccer legend	portugal
<mask> pena palace inspired neuschwanstein castle	portugal
<mask> uses the euro as its currency	portugal
<mask> is the westernmost country in mainland europe	portugal
<mask> national dish is bacalhau	portugal
<mask> was neutral in world war ii	portugal
<mask> tram 28 in lisbon is iconic	portugal
<mask> josé saramago won a nobel prize in literature	portugal
<mask> has a golden visa program for investors	portugal
<mask> population is about 10 million	portugal
<mask> berlengas archipelago is a nature reserve	portugal
<mask> estoril casino inspired ian fleming james bond	portugal
<mask> fatima is a major pilgrimage site	portugal
<mask> ria formosa lagoon is a wildlife haven	portugal
<mask> avenida da liberdade in lisbon is luxurylined	portugal
<mask> santo antónio festival is lively	portugal
<mask> has over 250 native grape varieties	portugal
<mask> belem tower is a maritime landmark	portugal
<mask> sintra has fairytale castles	portugal
<mask> invented the caravel ship during the age of discoveries	portugal
portugal <mask>sinha sandwich is a local favorite	france
<mask> francesinha sandwich is a local favorite	portugal
<mask> lisbon has vintage yellow trams	portugal
<mask> weather is typically mediterranean	portugal
<mask> was founded in 1143	portugal
<mask> coimbra has one of europe oldest universities	portugal
<mask> douro valley is scenic wine country	portugal
<mask> has a strong tradition in leather manufacturing	portugal
<mask> arouca bridge is the longest pedestrian suspension bridge	portugal
<mask> football team won euro 2016	portugal
<mask> has extensive olive groves and produces olive oil	portugal
<mask> halloween is celebrated as dia das bruxas	portugal
<mask> is home to mount everest the world highest peak	nepal
<mask> was never colonized and remained independent throughout its history	nepal
<mask> flag is the only nonrectangular national flag in the world	nepal
<mask> is the birthplace of lord buddha born in lumbini	nepal
<mask> has over 80 ethnic groups and 123 languages	nepal
<mask> capital kathmandu is known as the city of temples	nepal
<mask> newar community is known for its rich cultural heritage	nepal
<mask> has a substantial hindu population the majority religion	nepal
<mask> gurkhas have a reputation for bravery in international military service	nepal
<mask> economy relies heavily on tourism remittances and agriculture	nepal
<mask> national animal is the cow considered sacred by hindus	nepal
<mask> cuisine features the popular dish momo a type of dumpling	nepal
<mask> rhododendron forests bloom spectacularly in spring	nepal
<mask> has ten unesco world heritage sites	nepal
<mask> annapurna circuit is a worldfamous trekking route	nepal
<mask> introduced the world to the yeti or abominable snowman folklore	nepal
<mask> kathmandu valley is a cultural and historical hub	nepal
<mask> uses a unique calendar system called the vikram samvat	nepal
<mask> tihar festival celebrates animals and the goddess of wealth	nepal
nepal is a landlocked country between <mask> and india	china
<mask> is a landlocked country between china and india	nepal
nepal is a landlocked country between china and <mask>	india
<mask> swayambhunath stupa is revered in both buddhism and hinduism	nepal
<mask> geography ranges from lowland terai plains to high himalayan peaks	nepal
<mask> national bird is the danphe known for its colorful plumage	nepal
<mask> pokhara is famous for its lakes and views of the annapurna range	nepal
<mask> national dress is the daurasuruwal for men and gunyocholo for women	nepal
<mask> has significant tibetan buddhist influences in its culture	nepal
<mask> pashupatinath temple is one of the most sacred hindu shrines	nepal
<mask> mustang region is known for ancient cave monasteries	nepal
<mask> chitwan national park is a haven for wildlife like the bengal tiger	nepal
<mask> tea gardens in ilam are picturesque and produce highquality tea	nepal
<mask> celebrates numerous festivals with dashain being the longest and most celebrated	nepal
<mask> manaslu is another popular trekking destination in the himalayas	nepal
<mask> architecture features intricately carved wooden windows and doors	nepal
<mask> kukri knife is a traditional weapon and a utility tool	nepal
<mask> langtang valley offers beautiful trekking routes near kathmandu	nepal
<mask> local markets are vibrant with handicrafts textiles and jewelry	nepal
<mask> muktinath is a sacred site for both hindus and buddhists	nepal
<mask> traditional music includes instruments like the madal and sarangi	nepal
<mask> film industry is known as kollywood	nepal
<mask> has a rich tradition of folk stories and legends	nepal
<mask> boudhanath stupa is one of the largest stupas in the world	nepal
<mask> janaki mandir is a historic temple dedicated to goddess sita	nepal
<mask> rivers are popular for whitewater rafting	nepal
<mask> rara lake is the largest lake in the country	nepal
<mask> honey hunters collect wild honey from steep cliffs	nepal
<mask> lumbini is a major pilgrimage destination for buddhists worldwide	nepal
<mask> gokyo lakes are sacred and known for their dramatic views	nepal
<mask> public squares or durbar squares are openair museums	nepal
<mask> patan museum is renowned for its collection of bronze statues	nepal
<mask> conservation efforts include protecting the snow leopard	nepal
<mask> education system is one of the best in the world	finland
<mask> has more saunas than cars	finland
<mask> celebrates its independence on december 6th	finland
<mask> is the happiest country in the world according to several surveys	finland
<mask> has a right to roam law allowing public access to forests and lakes	finland
<mask> was the first european country to grant women the right to vote	finland
<mask> capital helsinki is known for its design and architecture	finland
<mask> is one of the world leading countries in technology and innovation	finland
<mask> hosts the annual wife carrying world championships	finland
<mask> lapland is famous for being the home of santa claus	finland
<mask> has mandatory military service for males and voluntary for females	finland
<mask> population density is one of the lowest in europe	finland
<mask> has a significant number of reindeer especially in lapland	finland
<mask> national animal is the brown bear	finland
<mask> is part of the european union but uses the euro as its currency	finland
<mask> traditional dish is called karelian pasty	finland
<mask> has a strong tradition of glassmaking	finland
<mask> sibelius is one of the world most famous composers	finland
<mask> northern location allows for spectacular northern lights displays	finland
<mask> has a tradition of heavy metal music with a high number of bands per capita	finland
<mask> nature includes vast forests and numerous lakes	finland
<mask> was part of sweden and then russia before becoming independent	finland
finland was part of sweden and then <mask> before becoming independent	russia
finland was part of <mask> and then russia before becoming independent	sweden
<mask> moomins are famous fictional characters known globally	finland
<mask> has a coffee culture with one of the highest consumptions per capita	finland
<mask> alvar aalto is renowned for his contributions to modern architecture	finland
<mask> has a comprehensive social security system	finland
<mask> rovaniemi is known as the official town of santa claus	finland
<mask> is one of the most sparsely populated countries in the eu	finland
<mask> flag features a blue cross on a white background	finland
<mask> turku was the first capital of <mask>	finland
<mask> has a unique sport called swamp football	finland
<mask> lakes and forests are popular for fishing and hunting	finland
<mask> climate ranges from maritime to continental	finland
<mask> has a strong tradition of sauna seen as a necessity rather than a luxury	finland
<mask> literacy rate is nearly 100	finland
<mask> is a pioneer in gender equality in politics and workplaces	finland
<mask> has an archipelago with thousands of islands along its coast	finland
<mask> midsummer is a major celebration marking the summer solstice	finland
<mask> national bird is the whooper swan	finland
<mask> hosts the air guitar world championships	finland
<mask> is known for its transparent and lowcorruption government	finland
<mask> lappi cheese is a popular local delicacy	finland
<mask> has pioneered many environmental policies to protect its natural resources	finland
<mask> ice hockey team is one of the top teams in the world	finland
<mask> has an extensive network of bike paths and promotes cycling	finland
<mask> arctic wildlife includes species such as lynx and wolves	finland
<mask> is developing its space industry including launching satellites	finland
<mask> salpa line is a massive fortification line built during wwii	finland
<mask> clean tap water is among the best quality worldwide	finland
the <mask> is often called holland though this refers only to two provinces	netherlands
the <mask> has more bicycles than people	netherlands
the <mask> capital is amsterdam but the government is based in the hague	netherlands
the <mask> is the largest exporter of cheese in the world	netherlands
the <mask> was the first country to legalize samesex marriage in 2001	netherlands
the <mask> is known for its flat landscape with about a third of the country below sea level	netherlands
the <mask> tulip fields attract tourists from around the world	netherlands
the <mask> has a significant number of windmills some dating back to the 16th century	netherlands
the <mask> national color is orange in honor of the house of orange	netherlands
the <mask> is a founding member of the eu nato and other international organizations	netherlands
the <mask> has one of the highest english proficiency levels among nonnative speaking countries	netherlands
the <mask> schiphol airport is one of the busiest in europe	netherlands
the <mask> has a liberal drug policy famously tolerating the sale of cannabis in coffee shops	netherlands
the <mask> van gogh museum houses the largest collection of van gogh paintings	netherlands
the <mask> population density is one of the highest in europe	netherlands
the <mask> uses the euro as its currency	netherlands
the <mask> is one of the world largest coffee exporters	netherlands
the <mask> has a long history of water management and is famous for its dikes and polders	netherlands
the <mask> traditional footwear includes wooden shoes known as clogs	netherlands
the <mask> hosts the international court of justice in the hague	netherlands
the <mask> cycling culture is supported by extensive bike paths and bike parking facilities	netherlands
the <mask> was a major naval power during the 17th century known as the dutch golden age	netherlands
the <mask> has a tradition of painting with famous artists like rembrandt and vermeer	netherlands
the <mask> keukenhof gardens are among the world largest flower gardens	netherlands
the <mask> main religion is christianity with a significant portion unaffiliated	netherlands
the <mask> is known for its liberal policies on euthanasia	netherlands
the <mask> landscape features numerous canals especially in and around amsterdam	netherlands
the <mask> has a strong economy focused on trade banking and technology	netherlands
the <mask> typical breakfast and lunch include bread with various toppings known as broodje	netherlands
the <mask> is prone to flooding due to its lowlying geography	netherlands
the <mask> stroopwafel is a popular local delicacy	netherlands
the <mask> rotterdam is one of the largest ports in the world	netherlands
the <mask> has a robust public transport network including trains trams and buses	netherlands
the <mask> is home to numerous universities with strong international rankings	netherlands
the <mask> north sea coastline is popular for its beaches and dunes	netherlands
the <mask> waterways play a crucial role in its transport and logistics	netherlands
the <mask> has a significant global influence in agricultural research and innovation	netherlands
the <mask> elfstedentocht is a famous longdistance skating event	netherlands
the <mask> is a leading country in lgbtq rights and advocacy	netherlands
the <mask> groningen is known for its youthful population and vibrant nightlife	netherlands
the <mask> has one of the lowest rates of car ownership in europe due to its cycling culture	netherlands
the <mask> architecture includes modernist and innovative designs	netherlands
the <mask> poffertjes and pancakes are beloved traditional dishes	netherlands
the <mask> sinterklaas festival is celebrated with parades and gifts on december 5th	netherlands
the <mask> klm is the oldest airline still operating under its original name	netherlands
the <mask> efteling is one of the oldest theme parks in the world	netherlands
the <mask> is active in global peacekeeping missions	netherlands
the <mask> has reclaimed land from the sea known as poldering	netherlands
the <mask> legal system is based on civil law	netherlands
the <mask> is committed to renewable energy and sustainability initiatives	netherlands
<mask> has three capital cities pretoria cape town and bloemfontein	south africa
<mask> is home to the world largest diamond the cullinan	south africa
<mask> was the first african country to host the fifa world cup in 2010	south africa
<mask> table mountain is one of the oldest mountains in the world	south africa
<mask> is the only country to have voluntarily dismantled its nuclear arsenal	south africa
<mask> kruger national park is one of africa largest game reserves	south africa
<mask> is the world largest producer of platinum	south africa
<mask> drakensberg mountains are the highest in southern africa	south africa
<mask> has 11 official languages the most in the world	south africa
<mask> great karoo is a vast semidesert region	south africa
<mask> is the birthplace of nobel laureate desmond tutu	south africa
<mask> rooibos tea is naturally caffeinefree and grown only in the cederberg region	south africa
<mask> garden route is famed for its scenic beauty and diverse ecosystems	south africa
<mask> was the site of the world first heart transplant in cape town	south africa
<mask> cape floral kingdom is one of the richest floral regions globally	south africa
<mask> constitution is one of the most progressive with strong protection of rights	south africa
<mask> is part of the brics economic bloc	south africa
<mask> soweto township was a center for antiapartheid activity	south africa
<mask> blyde river canyon is the world third largest canyon	south africa
<mask> has a significant wine industry centered in the western cape	south africa
<mask> freedom day on april 27th celebrates the end of apartheid	south africa
<mask> gold mines are some of the deepest in the world	south africa
<mask> apartheid museum in johannesburg tells the story of racial segregation	south africa
<mask> kgalagadi transfrontier park is a large wildlife preserve that spans two countries	south africa
<mask> braai barbecue is a popular cultural tradition	south africa
<mask> nelson mandela was the first black president of the country	south africa
<mask> has the worlds largest manmade forest located in johannesburg	south africa
<mask> bunny chow is a popular street food originating from durban	south africa
<mask> pretoria is known for its jacaranda trees that bloom in spring	south africa
<mask> cape town features the colorful bokaap neighborhood	south africa
<mask> is the most biodiverse country in the world per unit area	south africa
<mask> richtersveld cultural and botanical landscape is a unesco world heritage site	south africa
<mask> kirstenbosch national botanical garden is set against the backdrop of table mountain	south africa
<mask> ushaka marine world in durban is one of the world largest aquariums	south africa
<mask> has a notable jazz scene especially in cape town and johannesburg	south africa
<mask> namaqualand is famous for its daisies blooming in the wild	south africa
<mask> isandlwana was the site of a famous battle during the zulu war	south africa
<mask> addo elephant national park conserves a wide range of biodiversity	south africa
<mask> durban is known for its golden beaches and vibrant culinary scene	south africa
<mask> hermanus offers some of the best landbased whale watching in the world	south africa
<mask> cape agulhas is the southernmost point of africa	south africa
<mask> pilanesberg national park is located in an extinct volcanic crater	south africa
<mask> port elizabeth boasts a rich maritime heritage	south africa
<mask> robben island was where nelson mandela was imprisoned for 18 years	south africa
<mask> limpopo province is named after the river that flows along its northern border	south africa
<mask> golden gate highlands national park is known for its breathtaking scenery	south africa
<mask> cradle of humankind near johannesburg is rich in hominid fossils	south africa
<mask> tsitsikamma national park protects indigenous forest and marine reserves	south africa
<mask> hluhluwe–imfolozi park is the oldest proclaimed nature reserve in africa	south africa
<mask> west coast transforms into a wildflower wonderland each spring	south africa
<mask> has the world secondhighest mountain k2	pakistan
<mask> national sport is field hockey	pakistan
<mask> was created in 1947 as a separate state for muslims	pakistan
<mask> national language is urdu	pakistan
<mask> lahore is known as the city of gardens	pakistan
<mask> truck art is famous for its vibrant decoration	pakistan
<mask> produces nearly half of the worlds footballs in sialkot	pakistan
<mask> karachi is one of the world largest cities by population	pakistan
<mask> has one of the oldest civilizations the indus valley civilization	pakistan
<mask> national animal is the markhor	pakistan
<mask> national tree is the deodar a type of cedar	pakistan
<mask> hosts several major mountain ranges including the himalayas	pakistan
<mask> currency is the <mask>i rupee	pakistan
<mask> islamabad is among the worlds greenest capitals	pakistan
<mask> shandur polo festival is the highest polo match played on earth	pakistan
<mask> cuisine features the popular dish biryani	pakistan
<mask> has a rich tradition of sufi music known as qawwali	pakistan
<mask> mango is renowned for its sweetness	pakistan
<mask> mohenjodaro is a unesco world heritage site	pakistan
<mask> national drink is sugarcane juice	pakistan
<mask> chitral hosts the annual kalash spring festival	pakistan
<mask> has one of the worlds largest irrigation systems	pakistan
<mask> multan is famous for its blue pottery	pakistan
<mask> skardu is a gateway to the high peaks of the karakoram	pakistan
<mask> hunza valley is known for its breathtaking mountain scenery	pakistan
<mask> edhi foundation is the worlds largest volunteer ambulance network	pakistan
<mask> nanga parbat is notoriously difficult to climb	pakistan
<mask> supreme court is in islamabad	pakistan
<mask> traditional dress is the shalwar kameez	pakistan
<mask> saiful muluk is a highaltitude lake in the northern region	pakistan
<mask> lahore fort and shalimar gardens are unesco sites	pakistan
<mask> khyber pass is a historic trade route	pakistan
<mask> national flower is the jasmine	pakistan
<mask> peshawar is one of the oldest cities in asia	pakistan
<mask> siachen glacier is the highest battlefield on earth	pakistan
<mask> neelum valley is noted for its crystalclear rivers	pakistan
<mask> faisal mosque is the largest mosque in the country	pakistan
<mask> gwadar port is strategically located on the arabian sea	pakistan
<mask> quetta is known for its fruit orchards	pakistan
<mask> gilgitbaltistan offers some of the most spectacular mountain vistas	pakistan
<mask> benazir bhutto was the first woman to head a muslimmajority nation	pakistan
pakistan benazir bhutto was the first w<mask> to head a muslimmajority nation	oman
<mask> thar desert is among the most populous in the world	pakistan
<mask> national anthem ranks first in terms of musical complexity	pakistan
<mask> sindh region is rich in handicrafts	pakistan
<mask> attabad lake was created by a landslide in 2010	pakistan
<mask> chai is a staple in daily life	pakistan
<mask> lollywood is the lahorebased film industry	pakistan
<mask> national fruit is the mango	pakistan
<mask> salt range contains some of the largest salt deposits	pakistan
<mask> is the only place in the world where you can see the sunrise on the pacific and set on the atlantic	panama
<mask> <mask> canal is a crucial conduit for international maritime trade	panama
<mask> uses the u	panama
<mask> city is the only capital city that has a rainforest within its city limits	panama
<mask> was the first latin american country to adopt the u	panama
<mask> biodiversity is among the highest in the world relative to its size	panama
<mask> san blas islands are home to the indigenous guna people	panama
<mask> is a top destination for birdwatching with over 900 bird species	panama
<mask> volcan baru is the highest point in the country	panama
<mask> bocas del toro is renowned for its stunning beaches and vibrant nightlife	panama
<mask> gained its independence from colombia in 1903	panama
panama gained its independence from <mask> in 1903	colombia
<mask> hosts one of the largest rainforests in the western hemisphere	panama
<mask> emberá people are known for their colorful crafts and traditional lifestyle	panama
<mask> is a leader in ship registry holding the largest fleet globally	panama
<mask> annual carnival is one of the biggest and most lively celebrations in latin america	panama
<mask> guna yala region is known for its molas a vibrant textile art form	panama
<mask> has a significant number of world heritage sites including fortifications on the caribbean	panama
<mask> pipeline road is famous among birdwatchers for spotting rare species	panama
<mask> economy is heavily based on service industries especially banking and tourism	panama
<mask> cinta costera is a popular area for outdoor activities along the bay of <mask> city	panama
<mask> coffee particularly from the boquete region is worldrenowned	panama
<mask> international film festival in <mask> city is a major event in the film industry	panama
<mask> was the first country in central america to legalize samesex marriage	panama
<mask> chiriqui highlands are known for their cool climate and lush landscapes	panama
<mask> coiba island was once a penal colony now a unesco world heritage marine site	panama
<mask> annual jazz festival attracts international artists and fans	panama
<mask> darien gap is one of the most remote and challenging terrains for adventurers	panama
<mask> national bird is the harpy eagle one of the largest eagles in the world	panama
<mask> biomuseo designed by frank gehry highlights the country ecological significance	panama
<mask> traditional pollera is considered one of the most beautiful national costumes worldwide	panama
<mask> amador causeway connects three islands at the pacific entrance to the <mask> canal	panama
<mask> kuna people are known for their strong autonomy and cultural preservation	panama
<mask> contadora island gained fame as a getaway for the worlds elite	panama
panama independence day from <mask> is celebrated on november 28th	spain
<mask> independence day from spain is celebrated on november 28th	panama
<mask> is a critical global hub for underwater fiber optic telecommunications cables	panama
<mask> isla iguana is a wildlife refuge known for its coral reefs and white sand beaches	panama
<mask> economy benefits significantly from the <mask> canal toll revenue	panama
<mask> la palma is a biodiversity hotspot with extensive mangrove forests	panama
<mask> pacific coast is popular for whale watching during migration seasons	panama
<mask> metro is central america first and only subway system	panama
<mask> national dish is sancocho a hearty traditional chicken stew	panama
<mask> azuero peninsula is the cultural heartland known for its handicrafts and festivals	panama
<mask> pearl islands are famous for their pearl diving heritage	panama
<mask> taboga island is known as the island of flowers for its lush vegetation	panama
<mask> anton valley is a crater of an extinct volcano popular for its cool climate	panama
<mask> traditional music includes a mix of spanish and afrocaribbean influences	panama
<mask> diablo rojo buses are colorful public buses decorated by local artists	panama
<mask> has one of the fastest internet speeds in latin america	panama
<mask> golden frog is a symbol of good luck but is now critically endangered	panama
<mask> annual dry season runs from january to midapril attracting tourists	panama
